Mm, Mm, Mm, Mm, Mm, Gg, Mm, Mm, Mm, Mm, Mm, Mm, Hh, Gg, Mm, Gg, Hh, Mm, Mm, Mm, Hh, Gg, Mm, Gg, Hh, Mm, Mm, Mm, Mm, Mm, Mm, Gg, Mm, Mm, Mm, Gg
Mm, Mm, Mm, Mm, Mm, Mm, Hh, Mm, Hh, Hh^Fp, Hh, Hh, Hh^Fp, Mm, Mm, Mm, Hh^Fp, Mm, Hh, Mm, Hh^Fp, Mm, Mm, Mm, Hh^Fp, Hh, Hh, Hh^Fp, Hh, Mm, Hh, Mm, Mm, Mm, Mm, Mm
Mm, Mm, Hh, Hh, Hh, Hh, Gd, Hh, Hh^Fp, Gd, Gd, Hh, Gd, Hh, Hh, Hh, Gd, Hh^Fp, Hh, Hh^Fp, Gd, Hh, Hh, Hh, Gd, Hh, Gd, Gd, Hh^Fp, Hh, Gd, Hh, Hh, Hh, Hh, Mm
Mm, Mm, Hh, Gd, Hh, Gd, Gg, Gd, Gd, Gd, Gd, Hh^Vhh, Rp, Rp, Rp, Rp, Rp, Rp, Rp, Rp, Rp, Rp, Rp, Rp, Rp, Hh^Vhh, Gd, Gd, Gd, Gd, Gg, Gd, Hh, Gd, Hh, Mm
Mm, Hh, Hh, Gd, Gd^Fp, Gd, Gll^Fmw, Gg, Gg, Gg, Rp, Rp, Cf, Cf, Cf, Cf, Cf, Cf, 1 Kf, Ias, Ias, Ias, Ias, Ias, Ias, Rp, Rp, Gg, Gg, Gg, Gll^Fmw, Gd, Gd^Fp, Gd, Hh, Hh
Mm, Mm, Hh, Gd, Gd, Gg^Fp, Gg^Fp, Gg, Gg, Gg, Ias, Ias, Rp, Rp, Ias, Ias, Ias, Rp, Rp, Rp, Ias, Ias, Ias, Ias, Rp, Ias, Ias, Gg, Gg, Gg, Gg^Fp, Gg^Fp, Gd, Gd, Hh, Mm
Mm, Hh^Fmw, Gd^Fp, Hh, Gd, Gg, Gg, Gg, Rp, Rp, Gg, Rp, Gg, Rp, Rp, Rp, Gg, Gg, Gg, Gg, Gg, Rp, Rp, Rp, Gg, Rp, Gg, Rp, Rp, Gg, Gg, Gg, Gd, Hh, Gd^Fp, Hh^Fmw
Mm, Hh^Fp, Gd, Gd, Gg, Gg, Gg, Rp, Gg, Gg, Gg^Fp, Gg, Gg, Gg, Ias, Gg, Gd, Gd, Gd, Gd, Gd, Gg, Ias, Gg, Gg, Gg, Gg^Fp, Gg, Gg, Rp, Gg, Gg, Gg, Gd, Gd, Hh^Fp
Mm, Hh, Hh, Gd, Gd, Gg, Rp, Rp, Gg, Gg, Gll^Fmw, Gg^Fp, Gg, Gg, Rp, Rb, Hh, Hh^Vhh, Hh^Vfac, Hh^Vhh, Hh, Rb, Rp, Gg, Gg, Gg^Fp, Gll^Fmw, Gg, Gg, Rp, Rp, Gg, Gd, Gd, Hh, Hh
Mm, Mm, Hh, Hh^Vhh, Gd, Rp, Ias^Vfac, Rp, Gg, Gg, Gg, Gg, Gg, Gg, Rp, Rp, Gd, Hh, Gd, Hh, Gd, Rp, Rp, Gg, Gg, Gg, Gg, Gg, Gg, Rp, Ias^Vfac, Rp, Gd, Hh^Vhh, Hh, Mm
Mm, Hh, Gd, Gd, Gg, Rp, Rp, Rb, Gg, Gg, Gg, Gg, Gd, Gd, Gd, Rp, Rp, Gd, Gd, Gd, Rp, Rp, Gd, Gd, Gd, Gg, Gg, Gg, Gg, Rb, Rp, Rp, Gg, Gd, Gd, Hh
Hh, Hh, Gd, Gg, Rp, Rp, Gd, Gd, Gd, Gg, Gg, Gg, Gd, Hh, Gd, Gd, Gd, Rp, Hh, Rp, Rp, Gd, Gd, Hh, Gd, Gg, Gg, Gg, Gd, Gd, Gd, Rp, Rp, Gg, Gd, Hh
Gd, Gd, Gg, Gg, Rp, Gg, Gd, Hh^Vhh, Hh, Gll^Fp, Gll^Fp, Gg, Gd, Gd, Gd, Gd, Hh, Ias, Hh, Ias, Hh, Rp, Rp, Gd, Gd, Gg, Gll^Fp, Gll^Fp, Hh, Hh^Vhh, Gd, Gg, Rp, Gg, Gg, Gd
Gg, Gll^Fp, Gll^Fp, Gg, Rp, Gg, Gll^Fp, Hh, Gd, Gll^Fmw, Gg, Gg, Gd, Gd, Hh, Gd, Mm, Hh, Mm^Vov, Hh, Mm, Gd, Hh, Rp, Rp, Gg, Gg, Gll^Fmw, Gd, Hh, Gll^Fp, Gg, Rp, Gg, Gll^Fp, Gll^Fp
Gg, Gll^Fp, Gg, Gg, Rp, Gg, Gg, Gd, Gg, Gg, Gd, Gg, Gd, Hh, Mm, Mm, Mm, Mm, Mm, Mm, Mm, Mm, Cf, Hh, Rp, Gg, Gd, Gg, Gg, Gd, Gg, Gg, Rp, Gg, Gg, Gll^Fp
Gg, Gg, Gd, Gd, Rp, Gd, Gd, Gg, Gg, Gg, Gd, Gd, Gd, Hh, Hh, Mm, Mm, Mm, Mm, Mm, Mm, Mm, Rp, Rp, Gd, Gd, Gd, Gg, Gg, Gg, Gd, Gd, Rp, Gd, Gd, Gg
Gg, Gd, Hh, Hh, Rp, Cf, Hh, Gd, Gg, Gg, Gd, Hh, Hh, Mm, Mm, Mm, Mm, Mm, Mm, Mm, Rp, Rp, Mm, Cf, Hh, Hh, Gd, Gg, Gg, Gd, Hh, Cf, Rp, Hh, Hh, Gd
Gg, Gd, Gd, Hh, Rp, Hh, Gd, Gd, Gg, Gg, Gd, Hh, Hh, Mm, Mm, Mm, Mm, Cf, Rp, Rp, Mm, Mm, Mm, Mm, Hh, Hh, Gd, Gg, Gg, Gd, Gd, Hh, Rp, Hh, Gd, Gd
Gg, Gg, Gd, Rp^Vfac, Gd, Gg, Gg, Gg, Gg, Gd, Hh, Mm^Vov, Hh, Hh, Mm, Mm, Cf, 3 Rp, Mm^Vov, Cf, Mm, Hh, Hh, Hh, Mm^Vov, Gd, Gg, Gg, Gg, Gg, Gd, Rp^Vfac, Gd, Gg, Gg, Gg
Gd, Gd, Hh, Rp, Hh, Gd, Gd, Gg, Gg, Gd, Hh, Hh, Mm, Mm, Mm, Mm, Rp, Rp, Cf, Mm, Mm, Mm, Mm, Hh, Hh, Gd, Gg, Gg, Gd, Gd, Hh, Rp, Cf, Gd, Gd, Gg
Gd, Hh, Cf, Rp, Hh, Hh, Gd, Gg, Gg, Gd, Hh, Hh, Cf, Mm, Rp, Rp, Mm, Mm, Mm, Mm, Mm, Mm, Mm, Hh, Hh, Gd, Gg, Gg, Gd, Hh, Hh, Rp, Hh, Hh, Gd, Gg
Gg, Gd, Gd, Rp, Gd, Gd, Gg, Gg, Gg, Gd, Gd, Gd, Rp, Rp, Mm, Mm, Mm, Mm, Mm, Mm, Mm, Hh, Hh, Gd, Gd, Gd, Gg, Gg, Gg, Gd, Gd, Rp, Gd, Gd, Gg, Gg
Gll^Fp, Gg, Gg, Rp, Gg, Gg, Gd, Gg, Gg, Gd, Gg, Rp, Hh, Cf, Mm, Mm, Mm, Mm, Mm, Mm, Mm, Mm, Hh, Gd, Gg, Gd, Gg, Gg, Gd, Gg, Gg, Rp, Gg, Gg, Gll^Fp, Gg
Gll^Fp, Gll^Fp, Gg, Rp, Gg, Gll^Fp, Hh, Gd, Gll^Fmw, Gg, Gg, Rp, Rp, Hh, Gd, Mm, Hh, Mm^Vov, Hh, Mm, Gd, Hh, Gd, Gd, Gg, Gg, Gll^Fmw, Gd, Hh, Gll^Fp, Gg, Rp, Gg, Gll^Fp, Gll^Fp, Gg
Gd, Gg, Gg, Rp, Gg, Gd, Hh^Vhh, Hh, Gll^Fp, Gll^Fp, Gg, Gd, Gd, Rp, Rp, Hh, Ias, Hh, Ias, Hh, Gd, Gd, Gd, Gd, Gg, Gll^Fp, Gll^Fp, Hh, Hh^Vhh, Gd, Gg, Rp, Gg, Gg, Gd, Gd
Hh, Gd, Gg, Rp, Rp, Gd, Gd, Gd, Gg, Gg, Gg, Gd, Hh, Gd, Gd, Rp, Rp, Hh, Rp, Gd, Gd, Gd, Hh, Gd, Gg, Gg, Gg, Gd, Gd, Gd, Rp, Rp, Gg, Gd, Hh, Hh
Hh, Gd, Gd, Gg, Rp, Rp, Rb, Gg, Gg, Gg, Gg, Gd, Gd, Gd, Rp, Rp, Gd, Gd, Gd, Rp, Rp, Gd, Gd, Gd, Gg, Gg, Gg, Gg, Rb, Rp, Rp, Gg, Gd, Gd, Hh, Mm
Mm, Hh, Hh^Vhh, Gd, Rp, Ias^Vfac, Rp, Gg, Gg, Gg, Gg, Gg, Gg, Rp, Rp, Gd, Hh, Gd, Hh, Gd, Rp, Rp, Gg, Gg, Gg, Gg, Gg, Gg, Rp, Ias^Vfac, Rp, Gd, Hh^Vhh, Hh, Mm, Mm
Hh, Hh, Gd, Gd, Gg, Rp, Rp, Gg, Gg, Gll^Fmw, Gg^Fp, Gg, Gg, Rp, Rb, Hh, Hh^Vhh, Hh^Vfac, Hh^Vhh, Hh, Rb, Rp, Gg, Gg, Gg^Fp, Gll^Fmw, Gg, Gg, Rp, Rp, Gg, Gd, Gd, Hh, Hh, Mm
Hh^Fp, Gd, Gd, Gg, Gg, Gg, Rp, Gg, Gg, Gg^Fp, Gg, Gg, Gg, Ias, Gg, Gd, Gd, Gd, Gd, Gd, Gg, Ias, Gg, Gg, Gg, Gg^Fp, Gg, Gg, Rp, Gg, Gg, Gg, Gd, Gd, Hh^Fp, Mm
Hh^Fmw, Gd^Fp, Hh, Gd, Gg, Gg, Gg, Rp, Rp, Gg, Rp, Gg, Rp, Rp, Rp, Gg, Gg, Gg, Gg, Gg, Rp, Rp, Rp, Gg, Rp, Gg, Rp, Rp, Gg, Gg, Gg, Gd, Hh, Gd^Fp, Hh^Fmw, Mm
Mm, Hh, Gd, Gd, Gg^Fp, Gg^Fp, Gg, Gg, Gg, Ias, Ias, Rp, Ias, Ias, Ias, Ias, Rp, Rp, Rp, Ias, Ias, Ias, Rp, Rp, Ias, Ias, Gg, Gg, Gg, Gg^Fp, Gg^Fp, Gd, Gd, Hh, Mm, Mm
Hh, Hh, Gd, Gd^Fp, Gd, Gll^Fmw, Gg, Gg, Gg, Rp, Rp, Ias, Ias, Ias, Ias, Ias, Ias, 2 Kf, Cf, Cf, Cf, Cf, Cf, Cf, Rp, Rp, Gg, Gg, Gg, Gll^Fmw, Gd, Gd^Fp, Gd, Hh, Hh, Mm
Mm, Hh, Gd, Hh, Gd, Gg, Gd, Gd, Gd, Gd, Hh^Vhh, Rp, Rp, Rp, Rp, Rp, Rp, Rp, Rp, Rp, Rp, Rp, Rp, Rp, Hh^Vhh, Gd, Gd, Gd, Gd, Gg, Gd, Hh, Gd, Hh, Mm, Mm
Mm, Hh, Hh, Hh, Hh, Gd, Hh, Hh^Fp, Gd, Gd, Hh, Gd, Hh, Hh, Hh, Gd, Hh^Fp, Hh, Hh^Fp, Gd, Hh, Hh, Hh, Gd, Hh, Gd, Gd, Hh^Fp, Hh, Gd, Hh, Hh, Hh, Hh, Mm, Mm
Mm, Mm, Mm, Mm, Mm, Hh, Mm, Hh, Hh^Fp, Hh, Hh, Hh^Fp, Mm, Mm, Mm, Hh^Fp, Mm, Hh, Mm, Hh^Fp, Mm, Mm, Mm, Hh^Fp, Hh, Hh, Hh^Fp, Hh, Mm, Hh, Mm, Mm, Mm, Mm, Mm, Mm
