Hhd, Gg, Mm, Mm, Mm, Mm, Mm, Mm, Mm, Hhd, Hhd, Hhd, Hhd, Hhd, Hhd, Hhd, Gll^Fmf, Gll, Gll, Gll, Gll, Gll, Aa, Aa, Aa, Gll, Gll, Gll, Gll, Gll, Gll, Gll, Gll, Gll, Gll, Mm, Mm, Mm, Mm, Gll
Hhd, Mm, Hhd, Mm, Mm, Mm, Mm, Mm, Hhd, Hhd, Gll^Fmf, Hhd, Gll, Gll, Gll, Gll, Gll, Gll, Ias, Gll, Gll, Gll, Gll, Aa, Gll, Gll, Ias, Aa, Gd, Gd, Gll^Fmf, Gll, Gll, Gll, Aa, Gll, Hhd, Mm, Mm, Gll
Gll, Hhd, Hhd, Hhd, Hhd, Hhd, Hhd, Hhd, Hhd, Hhd, Gll, Gll, Gll, Gll, Rp^Vhcr, Gd, Ias, Ias, Cf, Ias, Ias, Gd, Gd, Gll, Ias, Ias, Rp^Vhcr, Ias, Ias, Gd, Hhd, Hhd, Gll^Fmf, Gll, Aa, Aa, Mm, Mm, Mm, Hhd
Aa, Gll, Gll, Gll^Fmf, Gll, Gll^Fmf, Gll, Gll, Gd, Gll, Ias, Urb^Vfac, Ias, Gd, Ias, Ias, Cf, Cf, Ias, Cf, 1 Kf, Ias, Ias, Ias, Gd, Ias, Gll^Fmf, Ias, Ias, Urb^Vfac, Gd, Hhd, Gll, Gll, Gll, Hhd, Mm, Mm, Hhd, Hhd
Gll, Aa, Gll, Gll, Gll, Gll, Gll, Gd, Ias, Ias, Gd, Ias, Gd, Ias, Ias, Cf, Ias, Ias, Gd, Ias, Ias, Ias, Ias, Gd, Gll, Hhd, Hhd, Gd, Gd, Ias, Ias, Gd, Gll, Gll, Gd, Hhd, Gll, Mm, Gll, Gll
Hhd, Gll, Hhd, Gll^Fmf, Gll, Gll, Gd, Rp^Vhcr, Ias, Gd, Aa, Aa, Gd, Gd, Ias, Cf, Ias, Rp^Vhcr, Gd, Gd, Ias, Gd, Gd, Rp^Vhcr, Gll, Gll^Fmf, Gll, Gd, Aa, Ias, Hhd, Ias, Ias, Rp^Vhcr, Gd, Gd, Aa, Gll, Gll^Fmw, Gll
Hhd, Hhd, Gll^Fmf, Gll, Gll, Gd, Gd, Ias, Gd, Gd, Gll, Aa, Gll, Gll, Gll, Ias, Gll, Gll, Gll, Gd, Ias, Gd, Gll, Gll, Gll, Gll, Gll, Aa, Gd, Ias, Ias, Hhd, Gll^Fmw, Gll^Fmw, Gll, Gd, Aa, Aa, Gll^Fmw, Gll
Gll^Fmf, Gll, Gll, Gll, Aa, Gll, Gll, Ias, Hhd, Hhd, Gll, Gll, Rp^Vhcr, Gll, Gll, Aa, Gll^Es, Gll, Gll^Fmf, Hhd, Ias, Hhd, Gll^Fmf, Gll, Aa, Gll, Gll, Gll, Rp^Vhcr, Ias, Ias, Hhd, Gll, Gll^Fmw, Gll, Aa, Aa, Aa, Gll, Gll
Gll, Gll^Fmf, Hhd, Gll, Gll, Gll, Gd, Ias, Gd, Hhd, Gd, Gll, Gll, Gll, Hhd, Gll, Gll, Gll, Wwg, Wwg, Wwg^Bsb|, Wwg, Wwg, Gll, Aa, Hhd, Gll^Fmf, Gll, Gll, Gd, Gd, Ias, Ias, Gd, Gll, Gll, Gll, Gll, Gll, Gll
Hhd, Hhd, Hhd, Gll^Fmf, Gll, Gd, Gd, Ias, Ias, Gd, Gll, Gll, Gll, Gll^Fmf, Hhd, Gll, Wwg, Wwg, Gll, Gll, Ias, Gll, Gll, Ai, Ai, Hhd, Hhd, Gll, Gll, Gd, Gll, Gll^Es, Ias, Ias, Ias, Gll, Gll, Gd, Gll, Gll
Hhd, Hhd, Hhd, Gll, Aa, Aa, Gll^Es, Urb^Vfac, Ias, Gd, Gll, Gll, Gll^Fmf, Hhd, Wwg, Wwg, Aa, Gll, Gll^Fmf, Hhd, Urb^Vfac, Hhd, Gll, Gll, Gll, Wwg, Gll, Gll, Gll, Gll, Gll, Gd, Ias, Urb^Vfac, Ias, Gd, Gll, Gll, Gll, Gll
Gll^Fmf, Gll^Fmf, Gll, Gll, Aa, Gll^Es, Ias, Ias, Hhd, Gll, Gll, Gll, Gll, Gll, Ai, Aa, Gll, Gll^Fmf, Gll, Ias, Ias, Ias, Gll, Gll^Fmf, Gll, Wwg, Wwg, Aa, Gll, Gll^Fmf, Gll^Fmf, Gd, Gd, Ias, Gd, Gd, Hhd, Gll^Fmf, Gll, Gll
Hhd, Gll, Gll, Gll, Gll, Ias, Gll, Gll^Fmf, Hhd, Gll^Fmf, Gll, Gll, Gll, Aa, Wwg, Aa, Gll, Gll^Fmf, Cf, Gll, Ias, Ias, Gll, Gll, Gll, Chr, Wwg, Gll, Gll, Gll^Fmf, Gll, Hhd, Gd, Ias, Gll, Gll^Fmf, Hhd, Hhd, Gll, Gll
Hhd, Hhd, Gll, Gll, Gll, Ias, Gll, Hhd, Gll^Fmf, Gll, Gll^Es, Gll, Gll, Rp^Vhcr, Wwg, Gll, Gll, Gll, Gll, Ias, Ias^Br/, Ias, Gll, Rp^Vhcr, Gll^Es, Gll, Wwg, Rp^Vhcr, Gll, Gd, Gd, Hhd, Hhd, Ias, Ias, Gd, Gll, Gll^Fmf, Gll, Gll
Hhd, Gll^Fmf, Gll, Gll, Rp^Vhcr, Ias, Gll, Gll, Gll^Es, Gll, Gll^Es, Gll, Gll, Wwg, Chr, Gll, Rr^Vhc, Gll^Es, Ias^Br/, Ias^Br/, Urb^Vfac, Ias^Br\, Ias^Br\, Ias, Ias, Cf, Gll, Wwg, Gll, Gd, Gll, Gll, Gll^Fmf, Gll, Ias, Gll, Rp^Vhcr, Gll, Gll, Gll
Gll^Fmf, Gll^Fmf, Gll, Gll, Ias, Ias, Ias, Gll, Gll, Gll, Gll, Gll, Wwg, Wwg, Gll, Gll, Ias, Ias^Br/, Ias, Ias, 3 Ias, Ias, Ias^Br|, Ias, Ias, Ias, Urb^Vfac, Ai, Wwg, Gll, Gll, Gll, Gll, Gll, Gll, Ias, Gll, Gll, Gll, Gll
Gll, Gll, Gll, Urb^Vfac, Ias, Gll, Gll, Gll, Gll, Gll, Gll, Wwg, Gll, Gll, Ias, Ias, Ias, Ias^Br|, Ias, Ias, Ias, Ias, Ias^Br|, Ias, Gll, Ias, Gll, Wwg, Gll, Gll, Gll, Ias, Ias, Hhd, Hhd, Hhd, Urb^Vfac, Gll, Gll, Gll
Gll, Gll, Gll, Gll, Ias, Gll, Gll, Gll, Gll, Gll, Gll, Wwg, Ai, Urb^Vfac, Gll, Ias, Gll, Ias^Br\, Ias^Br\, Urb^Vfac, Ias, Ias, Ias^Br/, Ias, Gll, Gll, Wwg, Wwg, Gll, Gll, Gll, Gll, Gll, Ias, Ias, Ias, Gll, Gll, Gll^Fmf, Gll^Fmf
Gll, Gll, Gll, Rp^Vhcr, Gll, Ias, Gll, Gll^Fmf, Gll, Gll, Gd, Gll, Wwg, Gll, Gll, Cf, Gll, Ias, Ias, Ias^Br\, Ias^Br\, Ias^Br/, Ias, Rr^Vhc, Gll, Chr, Wwg, Gll, Gll, Gll^Es, Gll, Gll^Es, Gll, Gll, Ias, Rp^Vhcr, Gll, Gll, Gll^Fmf, Hhd
Gll, Gll, Gll^Fmf, Gll, Gd, Ias, Ias, Hhd, Hhd, Gd, Gd, Gll, Rp^Vhcr, Wwg, Gll, Gll^Es, Rp^Vhcr, Ias, Ias, Ias, Gll, Ias, Cf, Gll, Gll, Wwg, Rp^Vhcr, Gll, Gll, Gll^Es, Gll, Gll^Fmf, Hhd, Gll, Ias, Gll, Gll, Gll, Hhd, Hhd
Gll, Gll, Hhd, Hhd, Gll^Fmf, Gll, Ias, Gd, Hhd, Gll, Gll^Fmf, Gll, Gll, Wwg, Chr, Gll, Gll, Gll, Ias, Ias, Gll, Gll, Gll^Fmf, Gll, Aa, Wwg, Aa, Gll, Gll, Gll, Gll^Fmf, Hhd, Gll^Fmf, Gll, Ias, Gll, Gll, Gll, Gll, Hhd
Gll, Gll, Gll^Fmf, Hhd, Gd, Gd, Ias, Gd, Gd, Gll^Fmf, Gll^Fmf, Gll, Aa, Wwg, Wwg, Gll, Gll^Fmf, Gll, Ias, Ias, Ias, Gll, Gll^Fmf, Gll, Aa, Ai, Gll, Gll, Gll, Gll, Gll, Hhd, Ias, Ias, Gll^Es, Aa, Gll, Gll, Gll^Fmf, Gll^Fmf
Gll, Gll, Gll, Gll, Gd, Ias, Urb^Vfac, Ias, Gd, Gll, Gll, Gll, Gll, Gll, Wwg, Gll, Gll, Gll, Hhd, Urb^Vfac, Hhd, Gll^Fmf, Gll, Aa, Wwg, Wwg, Hhd, Gll^Fmf, Gll, Gll, Gd, Ias, Urb^Vfac, Gll^Es, Aa, Aa, Gll, Hhd, Hhd, Hhd
Gll, Gll, Gd, Gll, Gll, Ias, Ias, Ias, Gll^Es, Gll, Gd, Gll, Gll, Hhd, Hhd, Ai, Ai, Gll, Gll, Ias, Gll, Gll, Wwg, Wwg, Gll, Hhd, Gll^Fmf, Gll, Gll, Gll, Gd, Ias, Ias, Gd, Gd, Gll, Gll^Fmf, Hhd, Hhd, Hhd
Gll, Gll, Gll, Gll, Gll, Gll, Gd, Ias, Ias, Gd, Gd, Gll, Gll, Gll^Fmf, Hhd, Aa, Gll, Wwg, Wwg, Wwg^Bsb|, Wwg, Wwg, Gll, Gll, Gll, Hhd, Gll, Gll, Gll, Gd, Hhd, Gd, Ias, Gd, Gll, Gll, Gll, Hhd, Gll^Fmf, Gll
Gll, Gll, Aa, Aa, Aa, Gll, Gll^Fmw, Gll, Hhd, Ias, Ias, Rp^Vhcr, Gll, Gll, Gll, Aa, Gll, Gll^Fmf, Hhd, Ias, Hhd, Gll^Fmf, Gll, Gll^Es, Aa, Gll, Gll, Rp^Vhcr, Gll, Gll, Hhd, Hhd, Ias, Gll, Gll, Aa, Gll, Gll, Gll, Gll^Fmf
Gll, Gll^Fmw, Aa, Aa, Gd, Gll, Gll^Fmw, Gll^Fmw, Hhd, Ias, Ias, Gd, Aa, Gll, Gll, Gll, Gll, Gll, Gd, Ias, Gd, Gll, Gll, Gll, Ias, Gll, Gll, Gll, Aa, Gll, Gd, Gd, Ias, Gd, Gd, Gll, Gll, Gll^Fmf, Hhd, Hhd
Gll, Gll^Fmw, Gll, Aa, Gd, Gd, Rp^Vhcr, Ias, Ias, Hhd, Ias, Aa, Gd, Gll, Gll^Fmf, Gll, Rp^Vhcr, Gd, Gd, Ias, Gd, Gd, Rp^Vhcr, Ias, Cf, Ias, Gd, Gd, Aa, Aa, Gd, Ias, Rp^Vhcr, Gd, Gll, Gll, Gll^Fmf, Hhd, Gll, Hhd
Gll, Gll, Mm, Gll, Hhd, Gd, Gll, Gll, Gd, Ias, Ias, Gd, Gd, Hhd, Hhd, Gll, Gd, Ias, Ias, Ias, Ias, Gd, Ias, Ias, Cf, Ias, Ias, Gd, Ias, Gd, Ias, Ias, Gd, Gll, Gll, Gll, Gll, Gll, Aa, Gll
Hhd, Hhd, Mm, Mm, Hhd, Gll, Gll, Gll, Hhd, Gd, Urb^Vfac, Ias, Ias, Gll^Fmf, Ias, Gd, Ias, Ias, Ias, 2 Kf, Cf, Ias, Cf, Cf, Ias, Ias, Gd, Ias, Urb^Vfac, Ias, Gll, Gd, Gll, Gll, Gll^Fmf, Gll, Gll^Fmf, Gll, Gll, Aa
Hhd, Mm, Mm, Mm, Aa, Aa, Gll, Gll^Fmf, Hhd, Hhd, Gd, Ias, Ias, Rp^Vhcr, Ias, Ias, Gll, Gd, Gd, Ias, Ias, Cf, Ias, Ias, Gd, Rp^Vhcr, Gll, Gll, Gll, Gll, Hhd, Hhd, Hhd, Hhd, Hhd, Hhd, Hhd, Hhd, Hhd, Gll
Mm, Mm, Mm, Hhd, Gll, Aa, Gll, Gll, Gll, Gll^Fmf, Gd, Gd, Aa, Ias, Gll, Gll, Aa, Gll, Gll, Gll, Gll, Ias, Gll, Gll, Gll, Gll, Gll, Gll, Hhd, Gll^Fmf, Hhd, Hhd, Mm, Mm, Mm, Mm, Mm, Hhd, Mm, Hhd
Mm, Mm, Gg, Gll, Gg, Gll, Gll, Gll, Gll, Gll, Gg, Gg, Gll, Gll, Gll, Gll, Gll, Gll, Gll, Gll, Gg, Gll, Gg, Gll, Gg, Gg, Gg, Gg, Gg, Gg, Gg, Mm, Mm, Mm, Mm, Mm, Mm, Mm, Mm, Mm
