Gs^Ft, Gs^Ft, Gs^Ft, Dd, Gs^Ft, Gs^Ft, Wwt, Gs^Ft, Gs^Ft, Gs^Ft, Gs^Ft, Gs^Ft, Gs^Ft, Gs^Ft, Gs^Ft, Gs^Ft, Gs^Ft, Gs^Ft, Gs^Ft, Gs^Ft, Gs^Ft, Dd, Dd, Dd, Dd, Dd, Dd, Dd, Dd, Dd, Dd, Dd, Dd, Dd, Dd, Dd, Ur, Dd, Dd, Dd, Dd, Dd, Dd, Dd, Dd, Dd, Dd^Edpp, Dd, Dd, Dd, Dd, Dd
Gs^Ft, Gs^Ft, Gs^Ft, Gs^Ft, Wwt, Wwt, Wot, Wwt, Wwt, Wwt, Wwt, Gs^Ft, Gs^Ft, Gs^Ft, Gs^Ft, Gs^Ft, Gs^Ft, Gs^Ft, Gs^Ft, Gs^Ft, Gd^Esd, Dd, Dd^Edpp, Dd, Dd^Esd, Ds, Dd^Dc, Dd, Dd^Do, Dd, Ds, Dd, Dd, Dd, Ur, Ur, Ur, Ur, Ur, Dd, Ds, Ds, Ds^Edpp, Dd^Dc, Dd, Dd, Ds, Dd, Dd, Dd, Ur^Br/, Ur^Br/
Gs^Ft, Gs^Ft, Gs^Ft, Gs^Ft, Wwt, Wot, Wot, Wot, Wot, Wot, Wwt, Gs^Ft, Gs^Ft, Gd, Gd, Gd, Gd, Gs^Ft, Gd, Gd, Dd, Gd, Gd, Gd^Esd, Gd^Esd, Ds^Esd, Dd^Edpp, Ds, Dd^Edpp, Ds, Dd, Dd, Ur, Ur, Ur, Ur, Ur, Ur, Ur, Ur, Ur, Dd, Ds^Edpp, Dd^Edpp, Dd, Ds, Dd, Dd, Ur^Br/, Ur^Br/, Ur, Ur
Gs^Ft, Gs^Ft, Wwt, Wwt, Wot, Wot, Wot, Wot, Wot, Wot, Wwt, Gs^Ft, Ds, Ds, Cd, Ds, Rd, Rd, Rd, Cd, Cd, Gd, Gd, Gd, Gd, Gd^Edpp, Ds^Edpp, Ds^Edpp, Ds, Ds, Ur, Ur, Ur, Ur, Ur, Xos, Xos, Xos, Ur, Ur, Ur, Ur, Ur, Ds, Ds, Ds, Ur^Br/, Ur^Br/, Ur, Ur, Ur^Br/, Ur^Br/
Gs^Ft, Gs^Ft, Wwt, Wot, Wot, Wot, Wot, Wot, Wwt, Wwt, Gs, Gs, Ds, Cd, Rd, Rd, Gd^Vda, Gd, Gd, Rd, Rd, Gd, Dd, Gd, Gd, Gd, Gd^Edpp, Ds^Esd, Ur, Ur, Ur, Ur, Ur, Xos, Xos^Efs, Xos, Ur, Xos, Xos, Xos, Ur, Ur, Ur, Ur, Ur^Br/, Ur^Br/, Ur, Ur, Ur^Br/, Ur^Br/, Dd, Dd
Gs^Ft, Gs^Ft, Gs^Ft, Wwt, Wwt, Wot, Wwt, Wwt, Ds, Wwt, Ds, Gs, Rd, Rd, Gd, Gd, Gd^Ft, Gd^Ft, Gd, Gd, Gd^Edpp, Rd, Ur, Ur, Ur, Gd, Ur, Ur, Ur, Ur, Ur, Xos, Xos^Efs, Xos, Ur, Ur, Ur, Ur, Ur, Xos, Xos^Efs, Ur, Ur^Br/, Ur^Br/, Ur, Ur, Ur^Br/, Ur^Br/, Ds, Ds, Dd^Edpp, Dd
Gs^Ft, Gs^Ft, Gs^Ft, Gs^Ft, Gs^Ft, Ds, Ds, Ds, Ds, Gs, Rd, Rd, Rd, Gd^Vda, Gd, Gd^Ft, Gd, Gd^Ft, Gd^Edpp, Gd^Vda, Ur^Esd, Ur, Ur, Ur, Ur, Ur, Ur, Ur, Ur, Xos, Xos^Efs, Xos, Ur, Ur, Ur, 2 Ur, Ur, Ur, Ur, Ur, Ur^Br/, Ur^Pr\, Rr^Pr\, Ur, Ur^Br/, Ur^Br/, Ur, Ur, Ur, Ds, Dd, Dd
Gs^Ft, Gs^Ft, Gs^Ft, Gs^Ft, Ds, Ds, Cd, Cd, Rd, Rd, Gd, Gd, Gd^Vda, Rd^Esd, Rd, Gd, Gd, Gd^Vda, Ur^Esd, Ur^Esd, Ur, Ur, Xos, Xos, Xos, Ur, Ur, Xos, Xos, Xos, Ur, Ur, Ur, Ur, Ur, Ur, Ur, Ur, Ur^Br/, Ur^Br/, Ur^Vud, Ur, Ur^Br/, Ur^Pr\, Xos^Efs, Ur, Xos, Ur, Ur, Ur, Ur, Dd
Gs^Ft, Gs^Ft, Gs^Ft, Gs, Gs, Ds, Rd, Rd, Gd, Gd^Vda, Cd, Cd, Gd^Ft, Gd^Edpp, Gd^Vda, Rd, Ur, Ur, Ur, Ur, Xos, Xos, Ur, Ur, Ur, Xos, Xos, Xos, Xos, Xos, Xos, Ur^Br\, Ur^Br\, Ur, Ur, Ur, Ur^Br/, Ur^Br/, Ur, Ur, Ur^Br/, Ur^Br/, Ur, Ur, Ur, Xos, Xos, Ur, Xos, Ur, Ur, Ur
Gs^Ft, Gs^Ft, Gs^Ft, Gd, Rd, Rd, Rd, Gd^Edpp, Gd, Gd^Ft, Gd, Cd, Gd, Gd, Ur, Ur, Ur, Ur, Xos, Xos, Ur, Ur, Ur, Xos, Xos, Ur, Ur, Xos, Xos, Xos, Xos, Xos, Xos, Ur^Br\, Ur^Br/, Ur^Br/, Ur, Ur^Vud, Ur^Br/, Ur^Br/, Ur, Ur, Ur, Ur, Ur, Ur, Ur, Xos, Xos, Ur, Ur, Ur
Dd, Cd, Rd, Rd, Gd^Ft, Gd^Vda, Gd, Rd, Rd, Gd^Vda, Gd, Gd^Ft, Ur, Ur, Ur, Ur, Xos, Xos, Ur, Ur, Ur, Xos, Xos, Ur, Ur, Xos, Xos, Ur, Ur, Xos^Efs, Xos, Xos, Urb^Br/, Urb^Br/, Xos, Ur^Br\, Ur^Br/, Ur^Br/, Ur, Ur, Ur, Ur, Ur, Ur, Ur, Ur, Xos, Xos, Ur, Xos, Ur, Ur
Dd, Dd, Rd, Gd, Gd, Gd, Gd^Ft, Gd^Vda, Gd^Edpp, Rd^Esd, Ur, Ur, Ur, Ur, Xos, Xos, Ur, Ur, Ur, Xos, Xos, Ur, Ur, Xos, Xos, Ur, Urb^Vud, Xos, Xos, Urb^Pr/o, Urb^Br/, Urb^Br/, Xos, Xos^Efs, Urb^Br/, Urb^Br/, Xos, Ur^Br\, Ur^Br\, Ur, Ur, Ur, Ur, Ur, Xos, Xos, Ur, Xos, Ur, Ur, Ur, Ur
Dd, Gd, Rd^Esd, Gd, Gd^Vda, Gd, Gd^Ft, Gd^Ft, Ur, Ur^Esd, Ur, Ur, Xos, Xos, Ur, Ur, Ur, Xos, Xos, Ur, Ur, Xos, Xos, Ur, Ur, Xos^Efs, Xos, Xos, Urb^Br/, Urb^Br/, Xos, Xos^Efs, Urb^Br/, Urb^Br/, Xos, Xos, Xos, Xos, Xos, Ur^Br\, Ur, Ur, Xos, Xos, Ur, Xos, Ur, Ur, Ur, Ur, Ds, Dd
Dd, Gd^Ft, Gd, Rd, Rd, Gd, Ur, Ur, Ur, Ur, Xos, Xos, Ur, Ur, Ur, Xos, Xos, Ur, Ur, Xos, Xos, Ur, Urb^Vud, Xos, Xos, Urb^Pr/o, Urb^Br/, Urb^Br/, Xos, Xos^Efs, Urb^Br/, Urb^Br/, Xos, Urb^Pr/o, Ur, Xos^Efs, Xos, Xos, Xos, Xos, Xos, Xos, Ur, Xos, Ur, Ur, Ur, Ur, Gd, Ds, Ds, Dd
Dd, Dd, Ds, Rd, Cd^Ft, Ur, Ur, Ur, Ur, Xos, Xos, Ur, Ur, Xos, Xos, Ur, Ur, Xos, Xos, Ur, Ur, Xos^Efs, Xos, Xos, Urb^Br/, Urb^Br/, Xos, Xos^Efs, Urb^Br/, Urb^Br/, Xos, Xos, Urb^Vud, Xos, Xos, Ur, Ur, Xos, Xos, Xos, Ur, Xos, Ur, Ur, Ur, Ur, Gd, Gd, Ds^Esd, Gd, Dd, Dd
Dd, Dd, Ds, Rd, Rd, Rd, Rd, Ur, Ur, Ur, Ur, Xos, Xos, Ur, Ur, Xos, Xos, Ur, Urb^Vud, Xos, Xos, Urb^Pr/o, Urb^Br/, Urb^Br/, Xos, Xos^Efs, Urb^Br/, Urb^Br/, Xos, Urb^Pr/o, Ur, Xos^Efs, Xos, Ur, Ur, Xos, Xos, Ur, Ur, Xos, Xos, Ur, Ur, Ur, Ur, Gd, Gd^Ft, Ds, Gd^Esd, Ds, Dd, Dd
Ds, Ds, Rd, Rd, Rd, Gd, Rd, Cd^Ft, Rd, Ur, Ur, Ur, Ur, Xos, Xos, Ur, Ur, Xos^Efs, Xos, Xos, Urb^Br/, Urb^Br/, Xos, Xos^Efs, Urb^Br/, Urb^Br/, Xos, Xos, Urb^Vud, Xos, Xos, Ur, Ur, Xos, Xos, Ur, Ur, Xos, Ur, Ur, Xos, Xos, Ur, Ur, Ur, Ur, Gd, Gd^Esd, Ds, Dd, Dd, Dd
Ds, Rd, Cd, Cd, Cd, Rd, Gd, Rd, Gd, Rd, Cd^Ft, Ur, Ur, Ur, Ur, Xos, Xos, Urb^Pr/o, Urb^Br/, Urb^Br/, Xos, Xos^Efs, Urb^Br/, Urb^Br/, Xos, Urb^Pr/o, Ur, Xos^Efs, Xos, Ur, Ur, Xos, Xos, Ur, Ur, Xos, Ur, Ur, Xos, Xos, Ur, Ur, Ur, Ur, Gd, Gd, Cd, Ds, Ds, Dd^Edpp, Dd^Dc, Dd
Ds, Rd, Rd, Cd, Rd, Rd, Rd, Gd^Edpp, Rd^Ebn, Rd, Ur, Ur, Ur, Ur, Xos, Xos, Urb^Br/, Urb^Br/, Xos, Xos^Efs, Urb^Br/, Urb^Br/, Xos, Xos, Urb^Vud, Xos, Xos, Ur, Ur, Xos, Xos, Ur, Ur, Xos, Ur, Ur, Xos, Xos, Ur, Ur, Ur, Ur, Rd, Gd, Gd^Vda, Gd, Cd, Cd, Dd, Dd, Dd, Dd
Rd^Vda, Rd, Gd, Rd, Gd^Ft, Rd, Cd^Ft, Rd, Ur, Ur, Ur, Ur, Xos, Xos, Urb^Br/, Urb^Br/, Xos, Xos^Efs, Urb^Br/, Urb^Br/, Xos, Urb^Pr/o, Ur, Xos^Efs, Xos, Ur, Ur, Xos, Xos, Ur, Ur, Xos, Ur, Ur, Xos, Xos, Ur, Ur, Ur, Ur, Gd^Vda, Gd, Gd^Ft, Rd, Rd, Gd, Gd, Gd, Dd, Dd, Dd, Dd
Gd, Rd, Rd^Vda, Gd^Ft, Gd^Ft, Rd, Rd, Ur, Ur, Ur, Ur, Xos, Urb^Br/, Urb^Br/, Ur, Ur, Urb^Br/, Urb^Br/, Xos, Xos, Ur, Xos, Xos, Ur, Ur, Xos, Xos, Ur, Ur, Xos, Ur, Ur, Xos, Xos, Ur, Ur, Ur, Ur, Gd^Vda, Gd, Gd, Gd, Gd, Gd, Gd, Rd, Gd, Ds^Esd, Dd, Dd, Dd, Dd
Rd^Vda, Rd, Gd, Gd, Gd^Edpp, Gd^Edpp, Gd^Ft, Rd, Cd^Ft, Ur, Ur^Br/, Ur^Br/, Ur, Ur, Urb^Br/, Urb^Br/, Xos, Xos, Ur, Ur, Ur, Ur, Ur, Xos, Xos, Ur, Ur, Xos, Ur, Ur, Xos, Xos, Ur, Ur, Ur, Ur, Rd, Gd, Gd^Edp, Gd, Gd^Ft, Gd, Gd, Gd^Vda, Rd, Rd, Dd^Ftd, Dd, Dd, Dd, Dd^Dc, Dd
Gd, Rd, Rd^Vda, Gd, Rd, Gd^Edpp, Rd^Ebn, Rd, Ur^Br/, Ur^Br/, Ur, Ur, Ur^Br/, Ur^Br/, Ur, Xos, Ur, Ur, Ur, Ur, Cd^Ft, Ur, Ur, Ur, Ur, Xos, Xos, Ur, Xos, Xos, Ur, Ur, Ur, Ur, Gd, Gd, Gd^Vda, Rd, Rd, Gd, Gd, Gd^Vda, Rd, Rd, Rd, Gd^Esd, Ds^Esd, Ds, Dd, Dd, Dd, Dd
Gd, Gd, Gd, Rd, Cd^Ft, Rd, Ur^Br/, Ur^Br/, Ur, Ur, Ur^Br/, Ur^Br/, Cd^Ft, Ur, Ur, Ur, Ur, Ur, Rd, Rd, Rd, Rd, Rd, Ur, Ur, Ur, Ur, Xos, Ur, Ur, Ur, Ur, Gd^Edpp, Gd, Gd^Edp, Gd, Gd^Ft, Gd, Gd^Vda, Rd, Rd, Rd, Gd^Vda, Gd^Ft, Gd^Ft, Rd, Rd, Dd, Dd, Dd^Do, Dd, Dd
Rd, Gd^Edpp, Rd^Ebn, Rd, Ur^Br/, Ur^Br/, Ur, Ur, Ur^Br/, Ur^Br/, Rd^Ebn, Rd^Esd, Rd, Rd, Rd^Esd, Ur, Rd, Rd^Ebn, Gd^Esd, Gd^Esd, Rd, Gd, Rd, Cd^Ft, Rd, Ur, Ur, Ur, Ur, Ur, Gd, Rd, Rd, Gd, Gd^Vda, Gd, Gd^Ft, Gd^Ft, Gd, Gd, Rd, Gd^Esd, Ds^Esd, Gd, Gd, Dd, Rd, Dd^Vda, Dd, Dd^Edpp, Dd^Edpp, Dd
Cd^Ft, Rd, Ur^Br/, Ur^Br/, 1 Ur, Ur, Ur^Br/, Ur^Br/, Cd^Ft, Rd, Gd, Gd^Edpp, Gd^Ft, Gd, Rd, Cd^Ft, Rd, Gd, Rd, Rd, Cd, Rd, Rd, Rd, Gd, Rd, Cd^Ft, Ur, Gd, Gd, Gd^Ft, Gd, Gd^Vda, Rd, Rd, Gd, Gd, Gd^Vda, Rd, Rd, Gd, Gd^Esd, Ds, Ds^Esd, Dd, Ds, Rd, Dd, Cd, Dd^Edpp, Dd, Dd
Ur^Br/, Ur^Br/, Ur, Ur, Ur^Br/, Ur^Br/, Rd^Ebn, Rd, Rd, Rd, Rd^Vda, Gd^Ft, Gd^Ft, Gd, Rd^Vda, Rd, Gd, Gd^Ft, Rd, Cd, Kd, Cd, Rd, Gd, Gd^Ft, Rd, Rd, Rd, Gd^Ft, Ds, Ds, Ds^Esd, Ds, Gd, Gd^Vda, Rd, Rd, Rd, Gd^Vda, Ds, Ds^Esd, Gd, Dd^Ftd, Ds, Dd, Dd^Vda, Dd, Rd, Dd, Dd, Dd, Dd
Ur, Ur, Ur^Br/, Ur^Br/, Cd^Ft, Rd, Ds^Esd, Ds, Dd, Ds, Dd, Rd, Rd^Vda, Gd, Gd, Rd, Rd^Vda, Rd, Rd^Esd, Cd, Cd, Cd, Rd, Rd, Rd, Rd, Gd, Gd, Ds, Gd^Ft, Dd, Ds^Esd, Dd^Esd, Dd, Dd, Gd, Rd, Gd, Dd, Ds^Esd, Dd, Dd^Ftd, Dd^Ftd, Dd^Edpp, Dd, Dd, Cd, Rd, Rd, Dd, Dd, Dd
Ur^Br/, Ur^Br/, Rd, Rd, Rd, Rd, Dd, Dd, Dd^Dc, Ds, Dd, Ds, Dd, Rd, Rd^Vda, Rd, Ds, Ds^Esd, Ds^Esd, Rd, Rd, Ds^Esd, Ds, Ds, Gd, Gd, Gd, Gd, Gd, Dd, Ds^Esd, Dd, Dd^Edpp, Dd^Ftd, Dd, Cd, Rd, Cd, Dd, Dd^Edpp, Dd^Dc, Dd, Dd, Dd, Dd, Dd^Ftd, Dd, Dd, Rd, Dd, Dd, Dd
Gg, Rd, Dd, Dd, Dd, Dd, Dd, Dd, Dd, Dd, Dd, Dd, Dd, Dd, Dd, Dd, Dd, Dd, Dd, Dd, Dd, Dd, Dd, Dd, Dd, Dd, Dd, Gd, Dd, Dd, Dd, Dd, Dd, Dd, Dd, Dd, Rd, Dd, Dd, Dd, Dd, Dd, Dd, Dd, Dd, Dd, Dd, Dd, Dd, Rd, Dd, Dd
