Wot, Wot, Wot, Wot, Wot, Wot, Wot, Wot, Wot, Wot, Wwt, Wwrt, Wwrt, Ds, Dd^Ftd, Dd, Hd, Hd, Dd, Dd, Rd, Dd, Dd, Hd, Hd, Dd, Dd, Dd, Hd, Dd, Hd, Hd, Hd, Hd, Dd
Wot, Wot, Wot, Wot, Wot, Wot, Wot, Wot, Wot, Wwt, Wwt, Wwrt, Ds, Dd^Ftd, Dd^Ftd, Dd^Ftd, Hd, Hd, Dd, Rd, Dd, Dd, Hd, Hd, Dd, Dd, Dd, Dd^Edpp, Hd, Hd, Hd, Hd, Hd, Hd, Dd
Wot, Wot, Wot, Wot, Wot, Wot, Wot, Wot, Wwt, Wwt, Ds, Ds, Rd, Dd^Ftd, Rd, Dd^Ftd, Dd, Dd, Rd, Rd, Dd^Ftd, Dd^Edpp, Hd, Hd, Dd, Dd, Dd, Hd, Hd, Hd, Hd, Hd, Dd, Dd, Dd
Wot, Wot, Wot, Wot, Wot, Wwt, Wwt, Wwt, Wwt, Wwrt, Wwrt, Ds, Cd, Cd, Cd, Rd, Rd, Dd, Rd, Dd, Dd, Dd, Hd, Dd, Dd, Dd, Hd, Hd, Hd, Hd, Dd, Dd, Rd, Dd, Rd
Wot, Wot, Wot, Wot, Wwt, Wwt, Wwt, Wwt, Ds, Wwrt, Rd, Rd, Rd, Rd, Rd, Rd, Ds, Rd, Rd, Rd, Rd, Dd, Dd, Dd, Dd, Hd, Hd, Hd, Hd, Dd, Rd, Rd, Dd, Rd, Dd
Wot, Wot, Wot, Wot, Wwt, Wwt, Ds, Ds, Cd, Ds, Rd, Rd, Rd, Rd^Esd, Rd, Rd, Rd, Ds, Rd, Cd, Cd, Rd^Esd, Rd, Dd, Dd, Dd, Dd, Dd^Edpp, Dd, Dd, Rd, Dd, Hd, Dd, Hd
Wot, Wot, Wot, Wwt, Wwt, Wwt, Cd, Cd, Rd, Rd, Rd, Dd^Vda, Ds, Ds, Ds, Dd^Vda, Ds, Rd, Rd^Esd, Rd, Rd, Cd, Rd, Dd, Dd, Dd, Rd, Dd, Rd, Rd, Dd, Dd, Hd, Hd, Hd
Wot, Wot, Wot, Wot, Wwt, Wwrt, Ds, Rd, Rd, Rd, Rd, Gd, Gs^Efm, Cd^Ft, Gs, Ds, Gd, Ds, Dd^Vda, Rd, Rd, Cd, Rd, Dd, Rd, Rd, Dd, Rd, Dd, Dd, Hd, Hd, Hd, Hd, Hd
Wot, Wot, Wot, Wwt, Wwt, Ds, Gd, Rd, Rd^Esd, Cf, Rd, Cd^Ft, Rd, Rd, Rd, Cd^Ft, Gs, Ds, Ds, Rd, Rd, Cd, Rd, Rd, Rd, Dd, Dd, Dd, Dd, Hd, Hd, Hd, Hd, Hd, Hd
Wot, Wot, Wot, Wot, Wwt, Iwr, Iwr, Cf, Rd, Rd, Rd, Rd, Cd, 2 Kd, Cd, Rd, Rd, Cd^Ft, Rd, Rd^Esd, Rd^Esd, Rd, Rd, Cd, Cd, Rd, Rd, Rd, Rd, Dd, Dd, Dd, Dd^Edpp, Hd, Dd
Wot, Wot, Wot, Wwt, Wwt, Wwt, Iwr, Rd, Ur, Ur^Vfac, Rd, Rd, Rd, Cd, Cd, Cd, Rd, Rd, Ds, Dd^Vda, Ds, Rd, Dd^Vda, Rd, Cd, Rd, Rd, Cd, Rd, Dd, Dd, Dd, Hd, Dd, Dd
Wot, Wot, Wot, Wot, Wwt, Wwt, Iwr, Ur^Vfac, Rd, Ur, Ur, Ur^Vfac, Rd, Rd, Rd, Rd, Gs, Cd^Ft, Gd, Ds, Ds, Rd, Rd, Rd, Rd^Esd, Rd^Es, Rd, Ztr, Rd, Dd, Dd, Hd, Hd, Hd, Hd
Wot, Wot, Wot, Wwt, Iwr, Iwr, Wwt, Iwr, Iwr, Ur^Vfac, Rd, Ur, Ur, Ur^Vfac, Rd^Es, Rd, Rd, Gs^Efm, Gs^Efm, Ds, Dd^Vda, Rd, Ds, Rd, Cd, Rd, Rd, Ztr, Rd, Dd, Rd, Dd, Dd, Hd, Hd
Wot, Wot, Wot, Wot, Wot, Wwt, Iwr, Iwr, Wwt, Iwr, Iwr, Ur^Vfac, Rd, Rd, Rd, Cf, Rd, Gs^Efm, Dd^Vda, Ds, Rd, Rd^Esd, Rd, Rd, Cd, Rd, Rd, Ztr, Rd^Edt, Rd, Cd, Rd, Hd, Hd, Hd
Wot, Wot, Wot, Wot, Wot, Wot, Wwt, Wwt, Iwr, Iwr, Wwt, Iwr, Rd, Cf, Rd, Rd, Rd^Vda, Gd, Rd, Rd, Gd^Efm, Ds, Rd, Cd, Rd, Rd, Rd, Ztr, Gd, Rd, Ztr, Rd, Dd, Hd, Hd
Wot, Wot, Wot, Wot, Wot, Wot, Wot, Wot, Wot, Wwt, Wwt, Iwr, Iwr, Rd, Ds^Vda, Rd, Rd, Rd, Rd, Ds^Vda, Rd, Rd, Cd, Rd, Ds, Gd, Cd, Ztr, Ztr, Rd, Ztr, Rd, Dd, Hd, Dd
Wot, Wot, Wot, Wot, Wot, Wot, Wot, Wot, Wot, Wwt, Wot, Wwt, Wwt, Rd, Rd, Gd, Ds^Vda, Ds, Rd^Esd, Rd, Cd, Cd, Gd^Efm, Rd^Edt, Rd, Rd, Cd, Cd, Rd^Edt, Ztr, Ztr, Rd, Dd, Dd, Dd
Wot, Wot, Wot, Wot, Wot, Wot, Wot, Wot, Wot, Wot, Wot, Wwt, Wwt, Ds, Cd, Rd, Rd, Rd, Cd, Rd, Rd, Gd, Rd, Rd, Ztr, Ztr, Rd, Rd^Edt, Rd^Edt, Rd, Ztr, Rd, Dd, Dd, Dd
Wot, Wot, Wot, Wot, Wot, Wot, Wot, Wot, Wot, Wot, Wwt, Wwt, Ds, Ds, Rd, Cd, Rd, Cd, Rd, Rd, Rd, Rd, Ztr, Ztr, Rd^Edt, Rd, Rd, Rd, Ztr, Ztr, Rd, Rd, Dd, Dd, Hd
Wot, Wot, Wot, Wot, Wot, Wot, Wot, Wot, Wot, Wot, Wwt, Ds, Cd, Rd, Rd, Rd, Rd, Rd^Esd, Rd, Rd, Cd, Ztr, Ztr, Rd^Edt, Rd^Edt, Gd, Rd, Ztr, Rd, Rd, Dd, Dd, Dd^Edpp, Hd, Hd
Wot, Wot, Wot, Wot, Wot, Wot, Wot, Wot, Wot, Wwt, Wwt, Cd, Cd, Ztr, Ztr, Rd, Ztr, Rd, Ztr, Ztr, Rd, Rd^Edt, Rd^Edt, Ztr, Ztr, Rd, Cd, Ztr, Rd, Dd, Dd, Dd, Hd, Hd, Hd
Wot, Wot, Wot, Wot, Wot, Wot, Wot, Wot, Wot, Wot, Wwt, Wwt, Ds, Rd, Rd, Ztr, Rd, Ztr, Rd, Gd, Rd, Rd^Edt, Ztr, Ztr, Rd, Cd, Rd, Rd, Dd, Dd, Dd, Hd, Hd, Hd, Dd
Wot, Wot, Wot, Wot, Wot, Wot, Wot, Wot, Wwt, Wot, Wwrt, Wwt, Ds, Ds^Edt, Rd, Ztr, Rd, Rd, Rd, Rd, Ztr, Ztr, Rd, Rd, Dd, Rd, Dd, Dd, Dd^Dc, Dd, Dd, Hd, Dd, Dd, Dd
Wot, Wot, Wot, Wot, Wot, Wot, Wot, Wot, Wwt, Wwt, Wwrt, Ds, Rd, Ztr, Ztr, Ztr, Ztr, Ztr, Cd, Cd, Rd, Rd, Dd, Dd, Dd, Dd, Dd, Dd, Dd, Dd, Hd, Dd, Cdr, Dd^Esd, Dd
Wot, Wot, Wot, Wot, Wot, Wot, Wot, Wot, Wwt, Ds, Dd, Ds, Dd, Rd, Rd, Rd, Rd, Rd, Rd, Rd, Dd, Dd, Dd, Dd, Dd^Esd, Dd^Esd, Dd, Hd, Hd, Hd, Hd, Hd, Dd, Dd, Hd
Wot, Wot, Wot, Wot, Wot, Wwt, Wwt, Wwrt, Ds, Ds, Dd, Dd, Dd, Dd, Dd^Edb, Dd, Dd, Dd, Dd, Dd, Dd^Dc, Dd, Dd, Dd, Hd, Dd^Esd, Hd, Hd, Hd, Hd, Dd, Dd, Dd, Hd, Hd
Wot, Wot, Wwt, Wwt, Wwt, Wwt, Ds, Ds, Ds, Dd, Hd, Dd^Dc, Dd, Dd^Edb, Hd, Dd, Hd, Dd, Hd, Dd, Dd, Dd, Dd, Hd, Hd, Hd, Hd, Hd, Hd, Hd, Dd, Dd^Dc, Dd, Dd, Dd
Wot, Wot, Wot, Wwt, Wwrt, Wwt, Ds, Dd, Dd, Dd, Dd, Hd, Hd, Hd, Hd, Hd, Hd, Hd, Dd^Edb, Dd^Edb, Dd^Edb, Dd, Hd, Hd, Hd, Hd, Hd, Hd, Hd, Dd^Edp, Dd, Dd, Dd^Esd, Dd^Esd, Dd
Wot, Wot, Wwt, Wwt, Wwrt, Wwrt, Wwf, Dd, Wwf, Dd, Dd, Dd, Dd, Hd, Dd, Hd, Dd, Dd^Esd, Dd^Esd, Hd, Hd, Hd, Hd, Hd, Hd, Hd, Hd, Hd, Hd, Hd, Dd, Dd^Vdr, Dd, Dd, Dd
Wwt, Wwt, Wwt, Dd, Dd, Dd, Dd, Wwf, Dd, Wwf, Wwf, Wwf, Wwf, Dd, Dd, Dd, Dd^Edpp, Dd^Esd, Hd, Hd, Hd, Hd, Hd, Hd, Dd^Edb, Dd^Edb, Dd^Esd, Dd^Esd, Dd^Esd, Dd, Dd, Dd, Hd, Dd, Hd
Dd, Dd, Dd, Dd, Dd^Esd, Dd^Esd, Dd^Edpp, Dd, Dd^Edb, Dd, Dd, Dd^Do, Dd, Wwf, Dd, Dd, Dd, Hd, Hd, Hd, Dd, Hd, Dd, Dd, Dd, Dd, Dd^Dc, Dd, 1 Cdr, Cdr, Dd, Dd^Edpp, Hd, Hd, Hd
Dd, Dd, Hd, Dd, Hd, Hd, Hd, Hd, Hd, Hd, Dd, Dd^Dc, Dd, Wwf, Wwf, Dd, Dd^Do, Dd, Dd, Dd, Dd, Dd, Dd, Dd^Vdr, Dd, Dd, Dd, Dd, Dd, Cdr, Hd, Hd, Hd, Hd, Hd
Hd, Hd, Hd, Hd, Hd, Hd, Hd, Dd^Vdr, Hd, Hd, Hd, Hd, Hd, Dd, Dd, Wwf, Dd, Dd, Dd, Dd, Hd, Dd, Hd, Dd, Hd, Hd, Hd, Hd, Hd, Hd, Hd, Hd, Hd, Hd, Hd
Dd, Hd, Dd, Hd, Dd, Hd, Dd, Hd, Dd, Hd, Dd, Hd, Dd, Dd, Dd, Wwf, Dd, Dd, Dd, Dd, Hd, Hd, Dd, Hd, Hd, Hd, Hd, Hd, Hd, Hd, Hd, Hd, Dd, Hd, Dd
