Dd, Dd, Dd, Dd, Dd, Dd, Dd, Dd, Dd, Dd, Dd, Dd, Dd, Dd, Dd, Dd, Dd, Dd, Dd, Dd, Dd, Dd, Wwg, Dd, Dd, Dd, Dd, Dd, Dd, Dd, Dd, Dd, Dd, Dd, Dd, Dd
Dd, Dd, Dd, Dd^Dc, Dd, Dd, Dd, Dd, Rd, Dd, Rd, Gd, Gd, Gd, Gd, Dd, Gd, Dd, Gd, Dd, Gd, Dd, Wwg, Dd, Dd, Dd^Dc, Dd^Edpp, Dd^Edpp, Dd, Dd, Dd, Dd, Dd, Dd^Dc, Dd, Dd
Dd, Dd, Dd^Edpp, Dd^Edpp, Dd, Dd, Rd, Rd, Cd, Rd, Cd, Rd, Gd, Gd^Edpp, Gd^Edb, Gd, Cdr, Gd, Gd, Gd^Edpp, Gs^Esd, Gs^Esd, Wwg, Cdr, Ds, Dd, Rd, Dd, Rd, Rd, Rd, Dd, Dd, Dd, Dd, Dd
Dd, Dd, Dd, Dd, Rd, Rd, Cd, Cd, Rd, Cd, Rd, Rd, Gd, Dd^Vda, Gd, Cdr, Gd, Gd, Hhd, Hhd, Hhd, Gs, Rd, Wwf, Cdr, Rd, Gd, Rd, Rd^Esd, Rd^Vfac, Rd, Dd, Dd^Edpp, Dd, Dd, Dd
Dd, Dd, Gd, Rd, 2 Kd, Cd, Rd, Rd, Gd, Rd, Ds, Rd, Rd^Esd, Gd, Rd, Cdr, Hhd, Gd, Rd, Rd^Vfac, Rd, Rd, Gd, Wwg, Wwg, Gd^Edb, Gd^Edb, Gd, Gs^Ftp, Rd^Esd, Rd, Dd, Dd, Dd^Dc, Dd, Dd
Dd, Dd, Gd, Rd, Rd, Rd, Gd, Gd^Edb, Gd, Dd^Vda, Ds, Gd, Gd^Edb, Rd^Esd, Ds, Rd, Rd, Rd^Vda, Rd^Esd, Rd, Gd, Rd, Rd, Gs^Ftp, Gd^Esd, Wwg, Gd^Esd, Gd, Gd, Rd^Vda, Rd, Dd, Dd, Dd, Dd, Dd
Dd, Gd, Gd^Edpp, Gd, Rd^Esd, Gd, Gs^Ftp, Dd^Vda, Gd, Gd, Gd, Gd, Gd^Edb, Ds, Ds, Cdr, Gd, Rd, Gs, Gd^Edpp, Hhd, Dd^Vda, Rd, Gd, Ds, Wwg, Cdr, Gd, Gd, Gd, Gd, Rd, Gd, Dd, Dd, Dd
Dd, Dd, Gd, Gd, Rd, Gd^Esd, Gd, Gs^Ftp, Gd, Gd^Vfac, Gs^Ftp, Gd, Gd, Gs, Gs, Cdr, Cdr, Gs^Esd, Gs^Ftp, Gd^Edb, Gd^Edb, Hhd, Rd, Rd^Vfac, Ds, Wwf, Kd, Ds, Gd, Gd, Gd, Rd^Esd, Rd, Gd, Dd, Dd
Dd, Gd, Gd, Rd, Gd, Gd, Gd, Gd^Edpp, Gd, Gd, Cdr, Cdr, Ds, Gd, Gs^Ftp, Gd, Wwg, Wwg, Ds, Dd^Vda, Rd^Esd, Rd^Esd, Wwg, Ds, Wwg, Wwg, Ds, Hhd, Hhd, Gd, Gd, Gd, Rd^Vda, Gd, Dd, Dd
Dd, Gd, Gd, Rd, Gd, Gd^Edpp, Gd, Gd, Dd^Do, Gd, Gd, Gs, Dd^Do, Gs^Ftp, Gs^Ftp, Dd^Vda, Wwg, Ds, 3 Rd^Vfac, Rd, Wwg, Wwg, Gs^Ftp, Wwg, Dd^Do, Gs^Esd, Gd, Hhd, Dd^Do, Gd, Gd^Edpp, Gd, Rd, Gd, Gd, Dd
Dd, Dd, Gd, Rd, Rd^Vda, Gd, Gd, Gd, Hhd, Hhd, Ds, Gs^Esd, Wwg, Wwg, Wwg, Wwg, Rd, Rd, Ds, Ds, Wwg, Dd^Vda, Gs^Ftp, Gs^Ftp, Ds, Gd, Cdr, Gd^Edb, Gd^Edb, Gd, Gd, Gd, Rd, Gd, Dd, Dd
Dd, Dd, Gd, Gd, Rd, Gd^Esd, Gd, Gd, Gd^Esd, Hhd, Kd, Wwg, Ds, Ds, Rd, Rd, Gd, Dd^Vda, Wwg, Wwg, Cdr, Gd, Gs, Gd^Edb, Gs^Esd, Cdr, Gs^Ftp, Gd, Gd, Gd, Gd, Gd, Rd, Gd, Gd, Dd
Dd, Dd, Dd, Gd, Gd, Rd, Rd, Gd^Edb, Gd^Edb, Ds, Cdr, Wwf, Ds, Rd^Vfac, Rd, Hhd, Hhd, Gs^Ftp, Gs^Esd, Gs^Edpp, Gd, Cdr, Ds, Gs, Gs, Gd, Gd^Edpp, Gd^Vfac, Gd, Gs^Ftp, Gs^Ftp, Gd, Rd^Esd, Gd, Gd, Dd
Dd, Dd, Dd, Dd, Gd, Gd, Gd, Rd, Gd, Gd, Gs, Wwg, Gd, Gd^Edpp, Rd, Dd^Vda, Gd^Edb, Gd^Esd, Rd^Esd, Rd, Rd, Cdr, Ds, Ds, Gd^Edb, Gd, Ds, Gd, Gd, Dd^Vda, Gd, Gd, Rd^Esd, Gd^Esd, Gd, Dd
Dd, Dd, Dd, Dd, Dd, Dd, Gd, Rd^Vda, Gs^Ftp, Gd, Gs^Esd, Wwg, Wwg, Gs^Ftp, Gd^Esd, Rd^Edb, Rd, Rd, Gs, Dd^Vda, Hhd, Rd, Rd, Gd^Edb, Gd, Gd, Ds, Dd^Vda, Gd, Gd, Rd, Rd, 1 Kd, Rd^Esd, Dd, Dd
Dd, Dd, Dd^Edpp, Dd, Dd, Dd, Rd, Rd, Rd, Gd, Gd^Esd, Gs, Cdr, Wwg, Ds^Esd, Rd, Hhd, Rd^Vfac, Hhd, Gs, Gd^Esd, Cdr, Gd, Rd, Rd, Gd, Rd, Rd, Rd, Rd, Cd, Cd, Rd, Rd, Dd, Dd
Dd, Dd, Dd^Dc, Dd^Edpp, Dd, Dd, Rd, Rd^Vfac, Rd, Rd, Rd, Rd, Rd, Wwf, Wwg, Gs^Edb, Gs, Hhd, Gd, Gd, Cdr, Cdr, Gd, Gd, Dd^Vda, Rd, Cd, Cd, Cd, Cd, Rd, Rd, Dd, Dd, Dd, Dd
Dd, Dd, Dd, Dd, Dd, Dd, Dd, Rd, Dd, Dd, Dd, Dd, Dd, Cdr, Wwg, Gs, Gd, Gs, Gd, Gd, Gd, Gd, Gd, Gd, Gd, Rd, Rd, Rd, Rd, Rd, Dd, Dd, Dd, Dd^Dc, Dd, Dd
Gd, Dd, Dd, Dd, Dd, Dd, Dd, Dd, Dd, Dd, Dd, Dd, Dd, Dd, Wwg, Dd, Dd, Dd, Dd, Dd, Dd, Dd, Dd, Dd, Dd, Dd, Dd, Dd, Dd, Dd, Dd, Dd, Dd, Dd, Dd, Dd
