Rb, Rb, Rb, Rb, Rb, Rb, Rb, Rb, Rb, Rb, Rb, Rb, Rb, Rb, Rb, Rb, Rb, Rb, Rb, Rb, Rb, Rb, Rb, Rb, Rb, Rb, Rb, Rb, Rb, Rb, Rb, Rb, Rb, Rb, Rb, Rb, Rb, Rb, Rb, Rb, Rb, Rb, Rb
Rb, Rb, Gll^Fdf, Rb, Gd, Rb, Gll^Fdf, Rb, Gll^Fdf, Rb, Gd^Gvs, Rb, Re, Rb, Gd^Gvs, Rb, Re, Rb, Re, Rb, Gd^Gvs, Rb, Gd^Gvs, Rb, Re, Rb, Re, Rb, Gd^Gvs, Rb, Re, Rb, Gd^Gvs, Rb, Gll^Fdf, Rb, Gll^Fdf, Rb, Gd, Rb, Gll^Fdf, Rb, Rb
Rb, Re, Gd, Gd, Rb, Gll^Fdf, Gll^Fdf, Gd, Gd, Gd^Gvs, Re, Re, Re, Re, Re, Gd^Vhr, Rb, Re, Re^Es, Re, Re, Gd^Gvs, Re, Re, Re^Es, Re, Rb, Gd^Vhr, Re, Re, Re, Re, Re, Gd^Gvs, Gd, Gd, Gll^Fdf, Gll^Fdf, Rb, Gd, Gd, Re, Rb
Rb, Re, Rb, Rb, Re^Vct, Ce, Ce, Re, Ce, 4 Ke, Rb, Rb, Re, Re, Re, Rb, Re, Re, Rb^Es, Rb, Cer, Re, Cer, Rb, Rb^Es, Re, Re, Rb, Re, Re, Re, Rb, Rb, 2 Ke, Ce, Re, Ce, Ce, Re^Vct, Rb, Rb, Re, Rb
Rb, Re^Es, Re^Es, Re^Vct, Re^Vct, Re^Vct, Re, Ce, Re^Es, Ur, Rb, Wwg, Rb, Rb^Es, Rb, Wwg, Re, Rb^Es, Rb^Es, Cer, Rb, Ker, Rb, Cer, Rb^Es, Rb^Es, Re, Wwg, Rb, Rb^Es, Rb, Wwg, Rb, Ur, Re^Es, Ce, Re, Re^Vct, Re^Vct, Re^Vct, Re^Es, Re^Es, Rb
Rb, Gd^Es, Re^Edt, Re^Es, Re^Es, Re, Rb, Re^Edt, Ur^Es, Ur^Es, Wwg, Wwg, Ur, Ur, Rb^Fdw, Rb, Ztr^Bp|, Rb^Es, Rb^Dr, Rb^Es, Uhe, Rb^Fdw, Uhe, Rb^Es, Rb^Dr, Rb^Es, Ztr^Bp|, Rb, Rb^Fdw, Ur, Ur, Wwg, Wwg, Ur^Es, Ur^Es, Re^Edt, Rb, Re, Re^Es, Re^Es, Re^Edt, Gd^Es, Rb
Rb, Rb^Edt, Rb^Edt, Rb^Edt, Wwg, Rb^Es, Ias, Rb^Edt, Uhe, Ur, Rb^Edt, Rb^Es, Ur^Es, Uhe, Ztr, Ztr, Rb, Ztr^Edt, Ztr^Edt, Ztr, Ztr, Uhe, Ztr, Ztr, Ztr^Edt, Ztr^Edt, Rb, Ztr, Ztr, Uhe, Ur^Es, Rb^Es, Rb^Edt, Ur, Uhe, Rb^Edt, Ias, Rb^Es, Wwg, Rb^Edt, Rb^Edt, Rb^Edt, Rb
Rb, Rb^Edt, Uhe, Ur^Edt, Rb^Fdw, Re^Es, Rb^Dr, Rb^Vhcr, Rb, Rb, Ztr^Edt, Rb^Es, Rb^Fdw, Ias, Rb^Dr, Re, Ias^Vfac, Ias, Rb^Es, Ur, Rb^Fdw, Uhe, Rb^Fdw, Ur, Rb^Es, Ias, Ias^Vfac, Re, Rb^Dr, Ias, Rb^Fdw, Rb^Es, Ztr^Edt, Rb, Rb, Rb^Vhcr, Rb^Dr, Re^Es, Rb^Fdw, Ur^Edt, Uhe, Rb^Edt, Rb
Rb, Ztr, Ztr, Ztr, Ztr, Ztr^Edt, Ztr, Uhe, Ztr^Edt, Ztr^Edt, Rb^Es, Ztr, Re^Edt, Rb^Vhcr, Wwg, Ias, Rb^Fdw, Rb^Es, Rb^Es, Wwg, Rb^Vhcr, Rb^Es, Rb^Vhcr, Wwg, Rb^Es, Rb^Es, Rb^Fdw, Ias, Wwg, Rb^Vhcr, Re^Edt, Ztr, Rb^Es, Ztr^Edt, Ztr^Edt, Uhe, Ztr, Ztr^Edt, Ztr, Ztr, Ztr, Ztr, Rb
Rb, Uhe, Rb^Dr, Ias^Es, Ias, Rb^Fdw, Ur, Ztr^Edt, Ztr, Rb^Fdw, Rb^Dr, Rb^Es, Rb^Fdw, Ur^Es, Ztr^Edt, Ur, Ztr^Edt, Uhe, Ztr^Edt, Re, Rb^Dr, Ias^Es, Rb^Dr, Re, Ztr^Edt, Uhe, Ztr^Edt, Ur, Ztr^Edt, Ur^Es, Rb^Fdw, Rb^Es, Rb^Dr, Rb^Fdw, Ztr, Ztr^Edt, Ur, Rb^Fdw, Ias, Ias^Es, Rb^Dr, Uhe, Rb
Rb, Rb^Es, Rb^Dr, Ias^Vfac, Ias, Rb^Vhcr, Ur, Ztr, Ztr, Uhe, Rb^Dr, Ias^Vfac, Rb^Fdw, Ztr, Ztr^Edt, Ztr^Edt, Ztr^Edt, Ztr^Edt, Ztr^Edt, Ztr, Rb^Dr, Ias^Vfac, Rb^Dr, Ztr, Ztr^Edt, Ztr^Edt, Ztr^Edt, Ztr^Edt, Ztr^Edt, Ztr, Rb^Fdw, Ias^Vfac, Rb^Dr, Uhe, Ztr, Ztr, Ur, Rb^Vhcr, Ias, Ias^Vfac, Rb^Dr, Rb^Es, Rb
Rb, Uhe, Ztr, Ias^Es, Ztr, Rb^Fdw, Ztr, Ztr^Edt, Ztr^Edt, Rb^Fdw, Rb^Es, Rb^Es, Re^Edt, Ur^Es, Wwg, Ur, Rb^Fdw, Uhe, Rb^Es, Re, Rb^Vhcr, Ias^Es, Rb^Vhcr, Re, Rb^Es, Uhe, Rb^Fdw, Ur, Wwg, Ur^Es, Re^Edt, Rb^Es, Rb^Es, Rb^Fdw, Ztr^Edt, Ztr^Edt, Ztr, Rb^Fdw, Ztr, Ias^Es, Ztr, Uhe, Rb
Rb, Ztr, Uhe, Ztr, Rb^Fdw, Ztr^Edt, Rb^Dr, Uhe, Rb, Ztr^Edt, Ztr^Edt, Ztr, Rb^Fdw, Rb^Vhcr, Rb^Dr, Ias, Ias^Vfac, Rb^Es, Rb^Es, Wwg, Rb^Fdw, Rb^Es, Rb^Fdw, Wwg, Rb^Es, Rb^Es, Ias^Vfac, Ias, Rb^Dr, Rb^Vhcr, Rb^Fdw, Ztr, Ztr^Edt, Ztr^Edt, Rb, Uhe, Rb^Dr, Ztr^Edt, Rb^Fdw, Ztr, Uhe, Ztr, Rb
Rb, Rb^Edt, Rb^Edt, Ur^Edt, Wwg, Re^Es, Ias, Rb^Vhcr, Uhe, Rb, Rb^Edt, Rb^Es, Ur^Es, Ias, Ztr, Re, Rb, Ias, Ztr^Edt, Ur, Ztr, Uhe, Ztr, Ur, Ztr^Edt, Ias, Rb, Re, Ztr, Ias, Ur^Es, Rb^Es, Rb^Edt, Rb, Uhe, Rb^Vhcr, Ias, Re^Es, Wwg, Ur^Edt, Rb^Edt, Rb^Edt, Rb
Rb, Rb^Edt, Re^Edt, Rb^Edt, Re^Es, Rb^Es, Rb, Rb^Edt, Ur^Es, Ur, Wwg, Rb^Es, Ur, Uhe, Rb^Fdw, Ztr, Ztr^Bp|, Ztr^Edt, Rb^Dr, Ztr, Uhe, Uhe, Uhe, Ztr, Rb^Dr, Ztr^Edt, Ztr^Bp|, Ztr, Rb^Fdw, Uhe, Ur, Rb^Es, Wwg, Ur, Ur^Es, Rb^Edt, Rb, Rb^Es, Re^Es, Rb^Edt, Re^Edt, Rb^Edt, Rb
Rb, Gd^Es, Re^Es, Re^Es, Re^Vct, Re, Re, Re^Edt, Re^Es, Ur^Es, Rb, Wwg, Rb, Ur, Rb, Rb, Re, Rb^Es, Rb^Es, Rb^Es, Rb, Rb^Fdw, Rb, Rb^Es, Rb^Es, Rb^Es, Re, Rb, Rb, Ur, Rb, Wwg, Rb, Ur^Es, Re^Es, Re^Edt, Re, Re, Re^Vct, Re^Es, Re^Es, Gd^Es, Rb
Rb, Re^Es, Rb, Re^Vct, Re^Vct, Re^Vct, Ce, Ce, Ce, Ur, Rb, Wwg, Re, Rb^Es, Re, Wwg, Re, Rb^Es, Rb^Es, Cer, Cer, Ker, Cer, Cer, Rb^Es, Rb^Es, Re, Wwg, Re, Rb^Es, Re, Wwg, Rb, Ur, Ce, Ce, Ce, Re^Vct, Re^Vct, Re^Vct, Rb, Re^Es, Rb
Rb, Re, Gd, Rb, Rb, Ce, Gll^Fdf, Re, Gd, 1 Ke, Re, Rb, Re, Re, Re, Rb, Rb, Re, Re^Es, Rb, Re, Re, Re, Rb, Re^Es, Re, Rb, Rb, Re, Re, Re, Rb, Re, 3 Ke, Gd, Re, Gll^Fdf, Ce, Rb, Rb, Gd, Re, Rb
Rb, Re, Gll^Fdf, Gd, Gd, Gll^Fdf, Gll^Fdf, Gd, Gll^Fdf, Gd^Gvs, Gd^Gvs, Re, Re, Re, Gd^Gvs, Gd^Vhr, Re, Re, Re, Re, Gd^Gvs, Gd^Gvs, Gd^Gvs, Re, Re, Re, Re, Gd^Vhr, Gd^Gvs, Re, Re, Re, Gd^Gvs, Gd^Gvs, Gll^Fdf, Gd, Gll^Fdf, Gll^Fdf, Gd, Gd, Gll^Fdf, Re, Rb
Rb, Rb, Rb, Rb, Rb, Rb, Rb, Rb, Rb, Rb, Rb, Rb, Rb, Rb, Rb, Rb, Rb, Rb, Rb, Rb, Rb, Rb, Rb, Rb, Rb, Rb, Rb, Rb, Rb, Rb, Rb, Rb, Rb, Rb, Rb, Rb, Rb, Rb, Rb, Rb, Rb, Rb, Rb
