Mm, Mm, Mm, Mm, Mm, Mm, Mm, Mm, Mm, Mm, Re, Mm, Mm, Mm, Mm, Mm, Mm, Mm, Mm, Mm, Mm, Mm, Mm, Mm, Mm, Mm, Mm, Mm, Mm, Mm, Mm, Mm, Mm, Mm, Mm, Mm, Hhd^Fmf, Mm, Mm, Mm, Hhd, Rb, Rb, Rb, Re^Gvs, Re^Gvs, Re^Gvs, Re^Gvs, Re^Gvs, Re^Gvs, Re^Gvs, Re^Gvs, Re^Gvs, Re^Gvs, Re^Gvs, Rb, Rb, Rb, Gll^Fdf, Gll^Fdf, Ur, Ur, Ur^Br/
Mm, Mm, Mm, Mm, Mm, Mm, Mm, Mm, Hhd, Mm, Re, Hhd, Mm, Mm, Mm, Mm, Mm, Mm, Mm, Mm, Mm, Mm, Mm, Mm, Hhd^Fmf, Mm, Hhd^Fmf, Hhd^Fmf, Hhd^Fmf, Hhd^Fmf, Hhd^Fmf, Hhd^Fmf, Hhd^Fmf, Hhd, Hhd, Hhd^Fmf, Hhd^Fmf, Hhd^Fmf, Hhd, Hhd, Rb, Rb, Gd^Gvs, Rb, Rb^Es, Re^Gvs, Re^Gvs, Re^Gvs, Re^Gvs, Re^Gvs, Re^Gvs, Re^Gvs, Re^Gvs, Re^Gvs, Rb^Es, Rb^Es, Gll^Fdf, Gll^Fdf, Ur, Ur, Ur^Br/, 3 Ur^Br/, Ur
Md^Xm, Mm, Mm, Mm, Mm, Mm, Mm, Hhd, Hhd, Re, Mm, Mm, Mm, Mm, Ur^Vfac, Mm, Mm, Mm, Mm, Mm, Hhd^Fmf, Mm, Hhd^Fmf, Hhd^Fmf, Hhd^Fmf, Hhd^Fmf, Hhd, Hhd^Fmf, Gd, Gd^Fmf, Re^Gvs, Re^Gvs, Hhd, Gd, Gd^Vl, Gd^Fmf, Gd, Gd^Fp, Rb, Rb, Gd^Gvs, Gd^Gvs, Gd^Gvs, Gd^Gvs, Gd^Gvs, Rb^Es, Rb, Re^Gvs, Gll^Fmf, Re^Gvs, Re^Gvs, Gll^Fmw, Rb, Rb^Es, Gll^Fdf, Gll^Fdf, Ur, Ur, Ur^Br/, Ur^Br/, Ur, Ur, Gll^Fdf
Md^Xm, Mm, Mm, Mm, Mm, Mm, Hhd, Hhd, Hhd, Re, Gd, Mm, Ur^Vfac, Urb, Ur^Br|, Urb^Vud, Ur^Vfac, Mm, Hhd^Fmf, Hhd^Fmf, Hhd^Fp, Hhd^Fmf, Hhd^Fp, Hhd^Fmf, Gd^Fmf, Hhd^Fmf, Gd, Hhd, Re^Gvs, Gd, Re^Gvs, Re^Gvs, Re^Gvs, Re^Gvs, Re^Gvs, Rb, Rb, Rb^Es, Gd^Gvs, Gll^Fmw, Gd^Gvs, Gd^Gvs, Gd^Gvs, Gd^Gvs, Gd^Gvs, Gd^Gvs, Gd^Gvs, Rb, Rb, Gll^Fmf, Rb, Rb, Gll^Fdf, Gll^Fdf, Ur, Ur, Ur^Br/, Ur^Br/, Ur, Ur, Gll^Fdf, Gll^Fdf, Rb
Md^Xm, Md^Xm, Mm, Mm, Mm, Mm, Hhd, Hhd, Gd, Re, Re, Gd, Ur^Vhcr, Ur^Br\, Ur^Br|, Ur^Br/, Ur^Vhcr, Hhd^Fmf, Hhd^Fp, Hhd^Fp, Hhd, Hhd^Fp, Re^Gvs, Hhd^Fmf, Gd^Vl, Gd, Re^Gvs, Re^Gvs, Re^Gvs, Re^Gvs, Re^Gvs, Re^Gvs, Gll^Fmw, Re^Gvs, Rb, Rb, Gd^Gvs, Gd^Gvs, Gd^Gvs, Gd^Gvs, Gd^Gvs, Gd^Gvs, Gd^Gvs, Gd^Gvs, Gd^Gvs, Gd^Gvs, Gd^Gvs, Gd^Gvs, Rb, Rb, Rb, Gll^Fdf, Ur, Ur, Ur^Br/, Ur^Br/, Ur, Ur, Gll^Fdf, Gll^Fdf, Rb, Rb, Re^Gvs
Md^Xm, Md^Xm, Md^Xm, Mm, Mm, Mm, Mm, Hhd, Hhd, Gd, Ztr, Re, Ur^Vfac, Urb^Br/, Ur^Br|, Urb^Br\, Ur^Vfac, Rb, Ztr, Gd, Re^Gvs, Gd, Re^Gvs, Re^Gvs, Re^Gvs, Rb, Rb, Re^Gvs, Re^Gvs, Re^Gvs, Re^Gvs, Gll^Fmf, Rb, Rb, Gd^Gvs, Gd^Gvs, Gd^Gvs, Gd^Gvs, Gd^Gvs, Gd^Gvs, Gd^Gvs, Gd^Gvs, Gd^Gvs, Gd^Gvs, Gll^Fmf, Gd^Gvs, Rb, Rb, Gll^Fdf, Gll^Fdf, Ur, Ur, Ur^Br/, Ur^Br/, Ur, Ur, Gll^Fdf, Gll^Fdf, Rb, Rb, Re^Gvs, Re^Gvs, Re^Gvs
Md^Xm, 2 Mm, Md^Xm, Mm, Mm, Mm, Mm, Mm, Hhd, Hhd, Ztr, Gd, Ur^Vhcr, Ur, Ur^Br|, Ur, Ur^Vhcr, Rb, Ztr, Re^Gvs, Re^Gvs, Re^Gvs, Re^Gvs, Re^Gvs, Re^Gvs, Re^Gvs, Re^Gvs, Rb^Es, Rb, Re^Gvs, Rb, Rb, Gll^Gvs, Rb, Rb, Gd^Gvs, Gd^Gvs, Gd^Gvs, Gd^Gvs, Gd^Gvs, Gd^Gvs, Gd^Gvs, Gll^Fmw, Gd^Gvs, Rb, Rb, Gll^Fdf, Gll^Fdf, Ur, Ur, Ur^Br/, Ur^Br/, Ur, Ur, Gll^Fdf, Gll^Fdf, Rb^Es, Rb^Es, Re^Gvs, Gll^Fmw, Re^Gvs, Re^Gvs, Re^Gvs
Md^Xm, Md^Xm, Mm, Mm, Mm, Hhd^Fp, Hhd^Fp, Hhd, Gd^Fp, Gd^Fp, Ztr, Gd, Ztr, Ur, Ur^Br|, Ur, Ztr, Rb, Ztr, Re^Gvs, Re^Gvs, Re^Gvs, Re^Gvs, Re^Gvs, Re^Gvs, Re^Gvs, Gll^Fmf, Re^Gvs, Rb, Rb, Gll^Gvs, Gll^Gvs, Gll^Gvs, Gll^Gvs, Gll^Fmw, Rb, Rb, Gll^Fmf, Gd^Gvs, Gd^Gvs, Gd^Gvs, Gll^Fmw, Rb, Rb, Gll^Fdf, Gll^Fdf, Ur, Ur, Ur^Br/, Ur^Br/, Ur, Ur, Gll^Fdf, Gll^Fdf, Rb, Rb, Re^Gvs, Re^Gvs, Re^Gvs, Re^Gvs, Re^Gvs, Re^Gvs, Re^Gvs
Md^Xm, Md^Xm, Mm, Mm, Mm, Hhd^Fp, Hhd^Fp, Hhd^Fp, Hhd^Fp, Hhd, Gd, Ztr, Gd, Ce, Ur^Br|, Ce, Rb, Ztr, Re^Gvs, Re^Gvs, Re^Gvs, Re^Gvs, Re^Gvs, Re^Gvs, Re^Gvs, Re^Gvs, Rb, Rb, Gll^Gvs, Gll^Gvs, Gll^Gvs, Gll^Gvs, Gll^Gvs, Gll^Gvs, Gll^Gvs, Gll^Gvs, Gll^Gvs, Rb, Rb^Es, Gd^Gvs, Rb, Rb, Gll^Fdf, Gll^Fdf, Ur, Ur, Ur^Br/, Ur^Br/, Ur, Ur, Gll^Fdf, Gll^Fdf, Rb, Rb, Gll^Fmw, Re^Gvs, Re^Gvs, Re^Gvs, Re^Gvs, Re^Gvs, Re^Gvs, Re^Gvs, Re^Gvs
Md^Xm, Mm, Mm, Mm, Mm, Mm, Mm, Mm, Mm, Hhd, Hhd, Gd, Gd, Gll^Fdf, Ur^Br|, Gll^Fdf, Rb, Re^Gvs, Re^Gvs, Re^Gvs, Re^Gvs, Re^Gvs, Gll^Fmw, Re^Gvs, Rb, Rb, Gll^Fmw, Gll^Fmf, Gll^Gvs, Gll^Gvs, Gll^Gvs, Gll^Gvs, Gll^Gvs, Gll^Gvs, Gll^Gvs, Gll^Gvs, Gll^Gvs, Gll^Gvs, Rb, Rb^Es, Rb, Gll^Fdf, Ur, Ur, Ur^Br/, Ur^Br/, Ur, Ur, Gll^Fdf, Gll^Fdf, Rb, Rb, Re^Gvs, Re^Gvs, Re^Gvs, Re^Gvs, Re^Gvs, Re^Gvs, Re^Gvs, Re^Gvs, Re^Gvs, Re^Gvs, Re^Gvs
Mm, Mm, Mm, Mm, Mm, Mm, Mm, Mm, Mm, Hhd, Gd, Gd, Gd, Gll^Fdf, Ur^Br|, Gll^Fdf, Gll^Fdf, Rb^Es, Rb^Es, Re^Gvs, Re^Gvs, Gll^Fmf, Rb, Rb, Gll^Fmw, Gll^Gvs, Gll^Gvs, Gll^Gvs, Gll^Gvs, Gll^Gvs, Gll^Gvs, Gll^Gvs, Gll^Gvs, Gll^Gvs, Gll^Fmf, Gll^Gvs, Rb, Rb, Gll^Fdf, Gll^Fdf, Ur, Ur, Ur^Br/, Ur^Br/, Ur, Ur, Gll^Fdf, Rb^Es, Rb, Rb, Re^Gvs, Re^Gvs, Re^Gvs, Re^Gvs, Re^Gvs, Re^Gvs, Re^Gvs, Re^Gvs, Re^Gvs, Re^Gvs, Gll^Fmf, Gll^Fmw, Rb
Mm, Mm, Mm, Mm, Mm, Mm, Mm, Mm, Hhd^Fp, Hhd, Hhd, Gd, Gd, Gll^Fdf, Gll^Fdf, Ur^Br\, Ur^Br\, Gll^Fdf, Gll^Fdf, Rb, Rb, Rb, Gll^Vl, Gll^Gvs, Gll^Gvs, Gll^Gvs, Gll^Gvs, Gll^Gvs, Gll^Gvs, Gll^Gvs, Gll^Gvs, Gll^Gvs, Gll^Gvs, Gll^Gvs, Rb, Rb, Gll^Fdf, Gll^Fdf, Ur, Ur, Ur^Br/, Ur^Br/, Ur, Ur, Gll^Fdf, Gll^Fdf, Rb^Es, Rb, Re^Gvs, Rb, Rb^Es, Re^Gvs, Re^Gvs, Re^Gvs, Re^Gvs, Re^Gvs, Re^Gvs, Re^Gvs, Re^Gvs, Gll^Fmf, Rb, Rb, Gd^Gvs
Mm, Mm, Mm, Mm, Mm, Mm, Mm, Hhd^Fp, Hhd^Fp, Hhd, Wwg, Gd, Gd, Gd, Gd, Gll^Fdf, Gll^Fdf, Ur^Br\, Ur^Br\, Rb, Gll^Fdf, Rb, Rb, Gll^Gvs, Gll^Gvs, Gll^Gvs, Gll^Gvs, Gll^Gvs, Gll^Gvs, Gll^Gvs, Gll^Fmf, Gll^Fmw, Rb, Rb, Gll^Fdf, Gll^Fdf, Ur, Ur, Ur^Br/, Ur^Br/, Ur, Ur, Gll^Fdf, Gll^Fdf, Rb, Rb^Es, Re^Gvs, Re^Gvs, Re^Gvs, Re^Gvs, Re^Gvs, Rb^Es, Rb, Re^Gvs, Gll^Fdw, Re^Gvs, Gll^Fmf, Re^Gvs, Rb, Rb^Es, Gd^Gvs, Gd^Gvs, Gd^Gvs
Mm, Mm, Mm, Mm, Mm, Mm, Mm, Hhd^Fp, Hhd^Fp, Wwg, Wwg, Wwg, Gd, Gd, Gd, Gd, Gd, Gll^Fdf, Gll^Fdf, Ur^Br\, Ur^Br\, Gll^Fdf, Gll^Fdf, Rb, Rb, Gll^Gvs, Gll^Gvs, Gll^Gvs, Gll^Gvs, Gll^Gvs, Rb, Rb, Gll^Fdf, Gll^Fdf, Ur, Ur, Ur^Br/, Ur^Br/, Ur, Ur, Gll^Fdf, Gll^Fdf, Rb, Rb, Re^Gvs, Re^Gvs, Re^Gvs, Re^Gvs, Re^Gvs, Re^Gvs, Re^Gvs, Re^Gvs, Re^Gvs, Rb, Rb, Gll^Fmw, Rb, Rb, Gd^Gvs, Gd^Gvs, Gd^Gvs, Gd^Gvs, Gd^Gvs
Mm, Mm, Mm, Mm, Mm, Mm, Mm, Hhd^Fp, Wo, Wwg, Gd, Gd, Gd, Gd, Hhd, Gd^Fp, Gd^Fp, Gd^Fp, Gd^Fp, Gll^Fdf, Gll^Fdf, Ur^Br\, Ur^Br\, Gll^Fdf, Gll^Fdf, Rb, Rb, Gll^Gvs, Rb^Es, Rb^Es, Gll^Fdf, Gll^Fdf, Ur, Ur, Ur^Br/, Ur^Br/, Ur, Ur, Gll^Fdf, Gll^Fdf, Rb, Rb, Re^Gvs, Gll^Fmw, Re^Gvs, Re^Gvs, Re^Gvs, Re^Gvs, Re^Gvs, Re^Gvs, Re^Gvs, Re^Gvs, Re^Gvs, Gll^Vl, Rb, Rb, Gll^Fmw, Gll^Fmf, Gd^Gvs, Gd^Gvs, Gd^Gvs, Gd^Gvs, Gd^Gvs
Mm, Mm, Mm, Mm, Mm, Mm, Hhd^Fp, Wwg, Wo, Wwg, Gd, Gd, Hhd, Hhd, Mm, Hhd, Hhd^Fp, Gd^Fp, Hhd^Fp, Gd^Fp, Gd^Fmw, Gll^Fdf, Gll^Fdf, Ur^Br\, Ur^Br\, Gll^Fdf, Gll^Fdf, Rb, Gll^Fdf, Gll^Fdf, Ur, Ur, Ur^Br/, Ur^Br/, Ur, Ur, Rb, Gll^Fdf, Rb, Rb, Gll^Fmw, Re^Gvs, Re^Gvs, Re^Gvs, Re^Gvs, Re^Gvs, Re^Gvs, Re^Gvs, Re^Gvs, Re^Gvs, Re^Gvs, Re^Gvs, Rb, Rb, Gd^Gvs, Gd^Gvs, Gd^Gvs, Gd^Gvs, Gd^Gvs, Gd^Gvs, Gd^Gvs, Gd^Gvs, Gd^Gvs
Mm, Mm, Mm, Mm, Mm, Hhd^Fp, Hhd^Fp, Wo, Wo, Wwg, Gd, Gd, Hhd, Mm, Mm, Hhd^Fp, Hhd^Fp, Hhd^Fp, Hhd^Fp, Gd^Fp, Gd^Fp, Gd^Fmw, Gd^Fmw, Gll^Fdf, Gll^Fdf, Ur^Br\, Ur^Br\, Gll^Fdf, Ur, Ur, Ur^Br/, Ur^Br/, Ur, Ur, Gll^Fdf, Gll^Fdf, Rb, Rb, Rb, Gll^Fmw, Gll^Fmw, Re^Gvs, Re^Gvs, Re^Gvs, Re^Gvs, Re^Gvs, Re^Gvs, Re^Gvs, Gll^Fmw, Gll^Fmf, Rb, Rb, Gd^Gvs, Rb^Es, Rb^Es, Gd^Gvs, Gll^Fmf, Gd^Gvs, Gd^Gvs, Gd^Gvs, Gd^Gvs, Gd^Gvs, Gd^Gvs
Mm, Mm, Mm, Mm, Mm, Hhd^Fp, Hhd^Fp, Wo, Wwg, Gd, Gd, Gd^Em, Hhd, Hhd^Fp, Mm, Mm, Hhd^Fp, Hhd^Fp, Hhd^Fp, Hhd^Fp, Gd^Fmw, Gd^Fmw, Gd^Fmw, Gd^Fmw, Gll^Fdf, Gll^Fdf, Ur, Ur^Br\, Ur^Br/, Ur^Br/, Ur, Ur, Gll^Fdf, Gll^Fdf, Rb, Rb, Gll^Gvs, Gll^Gvs, Gll^Gvs, Rb, Rb^Es, Re^Gvs, Re^Gvs, Re^Gvs, Re^Gvs, Re^Gvs, Re^Gvs, Re^Gvs, Rb, Rb, Gd^Gvs, Gd^Gvs, Gd^Gvs, Gd^Gvs, Gd^Gvs, Rb, Rb, Gll^Fmf, Gd^Gvs, Gd^Gvs, Gd^Gvs, Gd^Gvs, Gd^Gvs
Mm, Mm, Mm, Mm, Hhd^Fp, Hhd^Fp, Gd^Fp, Wwg, Wwg, Gd, Gd, Hhd, Gd, Hhd, Hhd, Hhd, Hhd, Gd^Fp, Gd^Fp, Gd^Fmw, Gd^Fp, Gd^Fmw, Gll^Fdf, Gll^Fdf, Ur, Ur, Ur^Br/, Ur^Br/, Ur, Ur^Br\, Ur^Br\, Gll^Fdf, Gll^Fdf, Rb, Rb, Gll^Gvs, Gll^Gvs, Gll^Gvs, Gll^Gvs, Gll^Gvs, Gll^Gvs, Rb^Es, Rb, Re^Gvs, Re^Gvs, Re^Gvs, Rb, Rb^Es, Gd^Gvs, Gd^Gvs, Gd^Gvs, Gd^Gvs, Gd^Gvs, Gd^Gvs, Gd^Gvs, Gd^Gvs, Gll^Fmw, Rb, Rb, Gll^Fmw, Gd^Gvs, Gd^Gvs, Gd^Gvs
Hhd, Mm, Hhd^Fp, Mm, Hhd^Fp, Hhd^Fp, Gd^Fp, Gd, Wwg, Gd, Gd, Gd, Gd, Gd, Gd, Gd^Em, Gd, Gd^Fp, Gd, Gd^Fp, Gll^Fdf, Gll^Fdf, Ur, Ur, Ur^Br/, Ur^Br/, Ur, Ur, Gll^Fdf, Gll^Fdf, Gll^Fdf, Ur^Br\, Ur^Br\, Gll^Fdf, Gll^Fdf, Rb^Es, Rb, Gll^Gvs, Gll^Gvs, Gll^Gvs, Gll^Gvs, Gll^Fdw, Gll^Fdw, Rb, Rb, Rb, Gll^Vl, Gd^Gvs, Gd^Gvs, Gd^Gvs, Gd^Gvs, Gd^Gvs, Gd^Gvs, Gd^Gvs, Gd^Gvs, Gd^Gvs, Gd^Gvs, Gd^Gvs, Gd^Gvs, Rb, Rb, Gd^Gvs, Rb
Hhd, Hhd, Hhd^Fp, Hhd^Fp, Hhd^Fp, Gd^Fp, Gd^Em, Gd, Gd, Gd, Gd, Gd, Gd^Edt, Gd, Ztr, Gd^Edt, Gd^Edt, Gd, Gll^Fdf, Gll^Fdf, Ur, Ur, Ur^Br/, Ur^Br/, Ur, Ur, Gll^Fdf, Gll^Fdf, Rb, Rb, Rb, Gll^Fdf, Gll^Fdf, Ur^Br\, Ur^Br\, Gll^Fdf, Gll^Fdf, Rb, Rb, Gll^Gvs, Gll^Gvs, Gll^Gvs, Gll^Gvs, Gll^Gvs, Gll^Gvs, Rb, Rb, Gd^Gvs, Gd^Gvs, Gd^Gvs, Gd^Gvs, Gd^Gvs, Gd^Gvs, Gd^Gvs, Gd^Gvs, Gd^Gvs, Gd^Gvs, Gd^Gvs, Gd^Gvs, Gd^Gvs, Rb^Es, Rb, Gll^Gvs
Hhd, Hhd, Gd^Fp, Hhd^Fp, Gd^Fp, Gd^Fp, Gd, Gd, Gd, Gd, Rb, Ztr, Ztr, Ztr, Rb^Edt, Ztr, Ztr, Gll^Fdf, Ur, Ur, Ur^Br/, Ur^Br/, Ur, Ur, Gll^Fdf, Gll^Fdf, Rb, Rb^Es, Gd^Gvs, Gd^Gvs, Gd^Gvs, Rb, Rb, Gll^Fdf, Gll^Fdf, Ur^Br\, Ur^Br\, Gll^Fdf, Gll^Fdf, Rb, Rb, Gll^Gvs, Gll^Gvs, Gll^Gvs, Gll^Gvs, Gll^Gvs, Rb, Rb, Rb, Gll^Fmw, Gd^Gvs, Gd^Gvs, Gd^Gvs, Gd^Gvs, Gd^Gvs, Gd^Gvs, Gd^Gvs, Gd^Gvs, Rb, Rb, Rb, Gll^Gvs, Gll^Gvs
Gd, Hhd, Gd^Fp, Gd^Fp, Gd^Fp, Gd^Fp, Gd^Fp, Cud, Rb, Rb, Ur^Vhc, Rb^Edt, Rb, Rb^Edt, Cud, Rb^Edt, Ur, Ztr, Ur^Br/, Ur^Br/, Ur, Ur, Gll^Fdf, Gll^Fdf, Rb^Es, Rb, Gll^Fmw, Gll^Fmw, Gd^Gvs, Gd^Gvs, Gd^Gvs, Gd^Gvs, Gll^Fmf, Rb, Rb, Gll^Fdf, Gll^Fdf, Ur^Br\, Ur^Br\, Gll^Fdf, Gll^Fdf, Rb, Rb, Gll^Gvs, Rb^Es, Rb, Gll^Gvs, Gll^Gvs, Gll^Gvs, Rb, Rb^Es, Gd^Gvs, Gd^Gvs, Gd^Gvs, Gd^Gvs, Gd^Gvs, Rb, Rb, Gd^Gvs, Gd^Gvs, Gd^Gvs, Rb, Rb
Gd^Fp, Gd^Fp, Gd^Fp, Gd^Fp, Cud, Gd^Fp, Rb, Rb, Ur^Vhc, Ur, Ur, Ur, Ur^Vfac, Ur, Ur, Ur, Ur^Br/, Ur^Br/, Ur, Ztr, Ztr, Gll^Fdf, Rb, Rb^Es, Gd^Gvs, Gd^Gvs, Gd^Gvs, Gd^Gvs, Gd^Gvs, Gd^Gvs, Gd^Gvs, Gd^Gvs, Gd^Gvs, Gd^Gvs, Gd^Gvs, Rb, Rb, Gll^Fdf, Gll^Fdf, Ur^Br\, Ur^Br\, Gll^Fdf, Gll^Fdf, Rb, Ztr, Ztr, Ztr, Ztr, Ztr, Gll^Gvs, Gll^Gvs, Rb, Rb, Gll^Vl, Rb, Rb, Gll^Fmf, Gll^Fmw, Gd^Gvs, Gd^Gvs, Gd^Gvs, Gd^Gvs, Gd^Gvs
Gd^Fp, Gd^Fp, Gd^Fp, Gd^Fp, Rb, Rb, Ur^Vhc, Ur, Ur, Ur, Ur^Vfac, Urb, Urb, Ur^Br\, Ur^Br/, Ur^Br/, Ur, Ur, Cud, Rb, Ztr, Rb, Rb, Gd^Gvs, Gd^Gvs, Gd^Gvs, Gd^Gvs, Gd^Gvs, Gd^Gvs, Gd^Gvs, Gd^Gvs, Gd^Gvs, Gd^Gvs, Gd^Gvs, Gd^Gvs, Gd^Gvs, Rb, Rb, Rb, Gll^Fdf, Gll^Fdf, Ur^Br\, Ur^Br\, Ce, Gll^Fdf, Rb, Rb, Gll^Gvs, Gll^Gvs, Gll^Gvs, Gll^Gvs, Gll^Fmw, Gll^Fdw, Rb, Rb, Gd^Gvs, Gd^Gvs, Gd^Gvs, Gd^Gvs, Gd^Gvs, Gd^Gvs, Gd^Gvs, Rb
Gd^Fp, Gd^Fp, Gd^Fp, Gd^Fp, Rb, Rb, Ur, Ur, Ur^Vfac, Urb, Urb, Ur^Br\, Ur^Br/, Ur^Br/, Urb, Ur^Br\, Ur^Vfac, Ur, Rb^Edt, Rb^Edt, Ztr, Rb, Re^Gvs, Rb, Rb, Gd^Gvs, Gd^Gvs, Gd^Gvs, Gd^Gvs, Gd^Gvs, Gd^Gvs, Gd^Gvs, Gll^Fmw, Gd^Gvs, Rb^Es, Rb^Es, Gll^Gvs, Gll^Gvs, Gll^Gvs, Rb, Ztr, Ce, Gll^Fdf, Ur^Br\, Ur^Br\, Ur^Vhcr, Ur^Vhcr, Rb, Ur^Vfac, Gll^Gvs, Gll^Gvs, Gll^Gvs, Gll^Gvs, Gll^Gvs, Gll^Gvs, Rb, Rb^Es, Gd^Gvs, Gd^Gvs, Gd^Gvs, Gd^Gvs, Gd^Gvs, Gd^Gvs
Gd^Fp, Gd^Fp, Gd^Fp, Gd^Fp, Rb, Rb, Ur, Urb, Urb, Ur^Br\, Ur^Br/, Ur^Br/, Urb, Ur^Br\, Ur^Vfac, Urb, Ur, Ur, Ur^Vhc, Rb^Edt, Ztr, Rb^Edt, Rb, Re^Gvs, Gll^Fmw, Rb, Rb, Gd^Gvs, Gd^Gvs, Gd^Gvs, Gll^Fmw, Gd^Gvs, Rb, Rb, Gll^Gvs, Gll^Gvs, Gll^Gvs, Gll^Gvs, Gll^Gvs, Gll^Gvs, Ztr, Rb, Ur^Vfac, Ur, Urb, Ur^Br\, Ur^Br/, Ur^Br/, Urb, Urb, Ur^Vfac, Gll^Gvs, Gll^Gvs, Gll^Gvs, Rb, Rb, Gll^Gvs, Rb^Es, Rb, Gd^Gvs, Gd^Gvs, Gd^Gvs, Rb
Gd^Fp, Gd^Fp, Gd^Fp, Gd^Fp, Gll^Fmw, Gll^Fmw, Ur, Urb, Ur^Br/, Ur^Br/, Urb, Ur^Br\, Ur^Vfac, Urb, Ur, Ur, Ur^Vhc, Ur, Rb, Rb^Edt, Rb^Edt, Ztr, Rb, Re^Gvs, Re^Gvs, Re^Gvs, Re^Gvs, Rb, Rb, Gll^Fmf, Rb, Rb, Gll^Gvs, Gll^Gvs, Gll^Gvs, Gll^Gvs, Gll^Gvs, Gll^Gvs, Gll^Gvs, Gll^Gvs, Ztr, Gll^Gvs, Gll^Gvs, Urb, Ur^Vfac, Ur^Br/, Urb, Ur^Br\, Ur^Br\, Ur^Br/, Ur^Vhcr, Rb, Rb, Rb, Gll^Gvs, Gll^Gvs, Gll^Gvs, Gll^Gvs, Gll^Fmw, Rb, Rb, Gd^Gvs, Gd^Gvs
Rb^Fp, Gd^Fp, Gll^Fmw, Gll^Fmw, Ur, Ur, Ur^Br/, Ur^Br/, Urb, Urb, Ce, Urb, Urb, Ur, Ur^Vhc, Ur, Rb, Rb, Rb, Cud, Rb, Ztr, Rb, Re^Gvs, Re^Gvs, Re^Gvs, Re^Gvs, Gll^Vl, Rb, Rb, Gll^Gvs, Gll^Gvs, Gll^Gvs, Gll^Gvs, Gll^Gvs, Gll^Gvs, Gll^Gvs, Gll^Gvs, Gll^Gvs, Gll^Gvs, Gll^Gvs, Ztr, Ztr, Rb, Gd^Gvs, Urb, Ur^Vfac, Ur^Br/, Ur^Vhcr, Ur^Vhcr, Rb, Rb, Ztr, Ztr, Gll^Gvs, Gll^Gvs, Gll^Gvs, Gll^Gvs, Gll^Gvs, Gll^Fmf, Gll^Fdw, Rb, Rb
Gll^Fmw, Gll^Fmw, Ur, Ur, Ur^Br/, Ur^Br/, Ur, Ur, Ur^Edt, Ce, 1 Ke, Ce, Ce, Ur^Edt, Rb^Edt, Rb^Edt, Cud, Rb, Rb, Rb, Re^Gvs, Rb, Re^Gvs, Re^Gvs, Gll^Fmw, Re^Gvs, Rb, Rb, Gll^Gvs, Gll^Gvs, Gll^Gvs, Gll^Gvs, Gll^Gvs, Gll^Gvs, Gll^Gvs, Gll^Gvs, Gll^Gvs, Gll^Gvs, Gll^Gvs, Gll^Gvs, Rb, Rb^Es, Gd^Gvs, Gll^Fmw, Ztr, Gd^Gvs, Gd^Gvs, Rb, Rb, Rb, Ztr, Ztr, Gll^Gvs, Gll^Gvs, Gll^Gvs, Gll^Gvs, Gll^Gvs, Gll^Gvs, Gll^Gvs, Gll^Gvs, Gll^Gvs, Gll^Gvs, Rb
Ur, Ur, Ur^Br/, Ur^Br/, Ur, Ur, Gll^Fmw, Gll^Fmw, Rb^Edt, Rb^Edt, Re^Gvs, Ce, Re^Gvs, Re^Gvs, Re^Gvs, Rb, Rb, Rb, Gll^Gvs, Rb, Rb, Re^Gvs, Re^Gvs, Gll^Fmf, Rb, Rb, Rb, Gll^Gvs, Gll^Gvs, Gll^Gvs, Gll^Gvs, Gll^Gvs, Gll^Gvs, Gll^Gvs, Gll^Gvs, Gll^Gvs, Gll^Fmw, Gll^Fmf, Rb, Rb, Rb, Gd^Gvs, Gd^Gvs, Gd^Gvs, Gd^Gvs, Ztr, Ztr, Gd^Gvs, Ztr, Ce, Rb, Gll^Gvs, Gll^Fmw, Gll^Gvs, Gll^Gvs, Gll^Gvs, Gll^Gvs, Gll^Gvs, Gll^Gvs, Gll^Gvs, Gll^Gvs, Gll^Gvs, Gll^Gvs
Ur^Br/, Ur^Br/, Ur, Ur, Gll^Fmw, Gll^Fmw, Rb, Rb, Re^Gvs, Re^Gvs, Re^Gvs, Re^Gvs, Re^Gvs, Re^Gvs, Rb, Rb, Gll^Fmw, Gll^Gvs, Gll^Gvs, Gll^Gvs, Gll^Gvs, Rb, Rb, Rb, Gd^Gvs, Gd^Gvs, Gd^Gvs, Rb^Es, Rb^Es, Gll^Fmw, Gll^Fmf, Gll^Gvs, Gll^Gvs, Gll^Gvs, Gll^Gvs, Gll^Gvs, Rb, Rb, Gd^Gvs, Gll^Vl, Gd^Gvs, Rb, Rb, Gd^Gvs, Gd^Gvs, Gd^Gvs, Gd^Gvs, Ztr, Gd^Gvs, Gd^Gvs, Gd^Gvs, Rb, Rb, Gll^Fmw, Gll^Gvs, Gll^Gvs, Gll^Gvs, Gll^Gvs, Gll^Gvs, Gll^Gvs, Gll^Gvs, Gll^Gvs, Gll^Gvs
Ur, Ur, Gll^Fmw, Gll^Fmw, Rb, Rb, Re^Gvs, Re^Gvs, Re^Gvs, Re^Gvs, Gll^Fmf, Re^Gvs, Rb, Rb, Gll^Gvs, Gll^Fmw, Gll^Gvs, Gll^Gvs, Gll^Gvs, Gll^Gvs, Rb, Rb, Gll^Fdw, Gd^Gvs, Gd^Gvs, Gd^Gvs, Gd^Gvs, Gd^Gvs, Gd^Gvs, Rb, Rb, Gll^Gvs, Gll^Gvs, Gll^Gvs, Rb, Rb, Gd^Gvs, Gd^Gvs, Gd^Gvs, Gd^Gvs, Gd^Gvs, Gll^Fmw, Gll^Fmw, Rb, Rb, Gd^Gvs, Gd^Gvs, Gd^Gvs, Gd^Gvs, Gd^Gvs, Gd^Gvs, Gd^Gvs, Gd^Gvs, Rb, Rb, Gll^Gvs, Gll^Fdw, Gll^Gvs, Gll^Gvs, Gll^Gvs, Gll^Gvs, Gll^Gvs, Gll^Gvs
Gll^Fmw, Gll^Fmw, Rb, Rb, Re^Gvs, Re^Gvs, Re^Gvs, Re^Gvs, Gll^Fmw, Gll^Fmf, Rb, Rb, Gll^Gvs, Gll^Gvs, Gll^Gvs, Gll^Gvs, Gll^Gvs, Gll^Gvs, Rb^Es, Rb^Es, Gd^Gvs, Gd^Gvs, Gd^Gvs, Gd^Gvs, Gd^Gvs, Gd^Gvs, Gd^Gvs, Gd^Gvs, Gd^Gvs, Gd^Gvs, Gd^Gvs, Rb, Rb, Rb^Es, Gd^Gvs, Gd^Gvs, Gd^Gvs, Gd^Gvs, Gd^Gvs, Gd^Gvs, Gd^Gvs, Gd^Gvs, Gd^Gvs, Gll^Fdw, Gd^Gvs, Rb, Rb, Gll^Fmw, Gd^Gvs, Gd^Gvs, Gd^Gvs, Gd^Gvs, Rb, Rb, Re^Gvs, Rb, Rb, Gll^Gvs, Gll^Gvs, Gll^Gvs, Gll^Gvs, Gll^Gvs, Gll^Gvs
Rb, Rb, Rb, Re^Gvs, Re^Gvs, Re^Gvs, Re^Gvs, Re^Gvs, Rb, Rb, Rb, Rb, Rb, Gll^Gvs, Rb, Gll^Gvs, Rb, Rb, Rb, Gd^Gvs, Gd^Gvs, Gd^Gvs, Gd^Gvs, Gd^Gvs, Rb, Gd^Gvs, Gd^Gvs, Gd^Gvs, Rb, Gd^Gvs, Rb, Rb, Rb, Rb, Rb, Gd^Gvs, Gd^Gvs, Gd^Gvs, Gd^Gvs, Gd^Gvs, Gd^Gvs, Gd^Gvs, Gd^Gvs, Gd^Gvs, Gd^Gvs, Gd^Gvs, Rb, Rb, Rb, Gd^Gvs, Rb, Rb, Rb, Re^Gvs, Rb, Re^Gvs, Rb, Rb, Rb, Gll^Gvs, Gll^Gvs, Gll^Gvs, Gll^Gvs
