Gll^Fdw, Gll^Fdw, Gll^Fdw, Gll^Fdw, Rb, Rb, Rb, Rb, Rb, Rb, Uu, Rb, Rb^Es, Rb, Rb, Rb, Rb, Re, Re, Rb, Hhd, Hhd, Hhd, Hhd, Hhd, Rb, Re, Re, Rb, Rb, Rb, Rb, Rb^Es, Rb, Uu, Rb, Rb, Rb, Rb, Rb, Rb, Gll^Fdw, Gll^Fdw, Gll^Fdw
Gll^Fdw, Gll^Fdw, Rb^Fdw, Rb^Es, Rb, Rb, Rb, Rb, Re, Re, Re^Es, Re^Es, Re, Re, Re, Uu, Re, Re, Rb^Fdw, Re, Re, Hhd, 3 Hhd, Hhd, Re, Re, Rb^Fdw, Re, Re, Uu, Re, Re, Re, Re^Es, Re^Es, Re, Re, Rb, Rb, Rb, Rb, Rb^Es, Rb^Fdw, Gll^Fdw
Rb, Gll^Fdw, Re, Rb, Re, Uu, Rb, Re, Uu, Re, Gll^Fdw, Rb^Fdw, Hhd, Hhd, Rb^Fdw, Re, Rb^Fdw, Hhd, Rb^Es, Rb, Re, Gll^Fdw, Hhd, Gll^Fdw, Re, Rb, Rb^Es, Hhd, Rb^Fdw, Re, Rb^Fdw, Hhd, Hhd, Rb^Fdw, Gll^Fdw, Re, Uu, Re, Rb, Uu, Re, Rb, Re, Gll^Fdw
Rb, Re, Re, Re, Re, Rb, Re^Edt, Re^Edt, Re, Gll^Fdw, Rb, Gll^Fdw, Rb^Es, Hhd, Rb, Rb, Rb, Rb^Es, Rb^Es, Rb, Re, Re, Rb, Re, Re, Rb, Rb^Es, Rb^Es, Rb, Rb, Rb, Hhd, Rb^Es, Gll^Fdw, Rb, Gll^Fdw, Re, Re^Edt, Re^Edt, Rb, Re, Re, Re, Re
Rb, Hhd, Hhd, Gll^Fdw, Hhd, Re, Uu, Rb^Edt, Rb^Edt, Re^Edt, Rb^Edt, Rb, Rb^Dr, Rb, Wwg, Uu, Re, Re, Re, Uu, Re, Rb, Uu, Rb, Re, Uu, Re, Re, Re, Uu, Wwg, Rb, Rb^Dr, Rb, Rb^Edt, Re^Edt, Rb^Edt, Rb^Edt, Uu, Re, Hhd, Gll^Fdw, Hhd, Hhd
Rb, Gll^Fdw, Hhd, Hhd, Re, Re, Rb, Rb^Es, Re, Re^Edt, Re, Re^Edt, Rb^Edt, Rb, Re, Re, Hhd, Rb, Hhd, Re, Re, Rb, Rb, Rb, Re, Re, Hhd, Rb, Hhd, Re, Re, Rb, Rb^Edt, Re^Edt, Re, Re^Edt, Re, Rb^Es, Rb, Re, Re, Hhd, Hhd, Gll^Fdw
Re, Re, Re, Rb^Fdw, Re, Rb, Re, Re, Hhd, Re, Gll^Feth, Re, Re, Uu, Re, Hhd, Re, Hhd, Re^Edt, Gll^Fdw, Re^Edt, Re^Edt, Rb, Re^Edt, Re^Edt, Gll^Fdw, Re^Edt, Hhd, Re, Hhd, Re, Uu, Re, Re, Gll^Feth, Re, Hhd, Re, Re, Rb, Re, Rb^Fdw, Re, Re
Rb, Rb^Edt, Rb, Re, Rb^Es, Rb^Dr, Re, Hhd, Gll^Fdw, Hhd, Rb, Rb, Re^Es, Re, Rb, Re, Re, Re^Edt, Uu, Re^Edt, Re^Edt, Rb^Edt, Rb, Rb^Edt, Re^Edt, Re^Edt, Uu, Re^Edt, Re, Re, Rb, Re, Re^Es, Rb, Rb, Hhd, Gll^Fdw, Hhd, Re, Rb^Dr, Rb^Es, Re, Rb, Rb^Edt
Rb, Rb, Wwg, Re^Es, Uu, Re^Edt, Re, Rb, Rb, Rb^Fdw, Rb^Edt, Rb^Edt, Re^Edt, Rb^Es, Uu, Wwg, Re, Rb, Gll^Fdw, Rb^Edt, Rb, Re, Re, Re, Rb, Rb^Edt, Gll^Fdw, Rb, Re, Wwg, Uu, Rb^Es, Re^Edt, Rb^Edt, Rb^Edt, Rb^Fdw, Rb, Rb, Re, Re^Edt, Uu, Re^Es, Wwg, Rb
Re^Edt, Uu, Re, Rb, Re^Edt, Rb, Wwg, Wwg, Re, Rb, Re, Uu, Rb^Edt, Rb^Edt, Re^Edt, Re, Hhd, Hhd, Hhd, Hhd, Hhd, Rb^Fdw, Re, Rb^Fdw, Hhd, Hhd, Hhd, Hhd, Hhd, Re, Re^Edt, Rb^Edt, Rb^Edt, Uu, Re, Rb, Re, Wwg, Wwg, Rb, Re^Edt, Rb, Re, Uu
Rb, Re, Gll^Fdw, Re, Re^Edt, Rb^Edt, Rb^Edt, Re, Rb^Fdw, Re, Gll^Fdw, Re, Re, Rb^Edt, Rb^Edt, Re^Edt, Rb^Edt, Rb^Dr, Re^Edt, Rb^Edt, Re^Es, Re, Rb, Re, Re^Es, Rb^Edt, Re^Edt, Rb^Dr, Rb^Edt, Re^Edt, Rb^Edt, Rb^Edt, Re, Re, Gll^Fdw, Re, Rb^Fdw, Re, Rb^Edt, Rb^Edt, Re^Edt, Re, Gll^Fdw, Re
Re, Hhd, Hhd, Hhd, Hhd, Re^Edt, Rb, Rb, Hhd, Hhd, Hhd, Hhd, Re, Wwg, Re, Re^Edt, Re^Edt, Re^Edt, Rb^Edt, Re^Edt, Rb, Rb^Es, Rb, Rb^Es, Rb, Re^Edt, Rb^Edt, Re^Edt, Re^Edt, Re^Edt, Re, Wwg, Re, Hhd, Hhd, Hhd, Hhd, Rb, Rb, Re^Edt, Hhd, Hhd, Hhd, Hhd
Re, Re, Re^Es, Re^Es, Re, Re, Uu, Re, Re^Edt, Re, Re, Re, Rb^Dr, Re^Es, Rb^Es, Uu, Rb^Edt, Rb^Edt, Rb^Edt, Wwg, Rb^Edt, Uu, Rb, Uu, Rb^Edt, Wwg, Rb^Edt, Rb^Edt, Rb^Edt, Uu, Rb^Es, Re^Es, Rb^Dr, Re, Re, Re, Re^Edt, Re, Uu, Re, Re, Re^Es, Re^Es, Re
Rb, Rb, Rb, Rb^Edt, Rb^Edt, Rb, Rb^Edt, Rb^Edt, Wwg, Rb^Edt, Rb^Edt, Rb^Edt, Rb^Edt, Rb^Edt, Rb^Edt, Rb^Edt, Rb, Rb, Uu^Eff, Rb^Edt, Rb^Eff, Rb, Rb^Eff, Rb, Rb^Eff, Rb^Edt, Uu^Eff, Rb, Rb, Rb^Edt, Rb^Edt, Rb^Edt, Rb^Edt, Rb^Edt, Rb^Edt, Rb^Edt, Wwg, Rb^Edt, Rb^Edt, Rb, Rb^Edt, Rb^Edt, Rb, Rb
Rb^Eff, Rb^Eff, Rb^Eff, Uu, Rb^Eff, Rb^Edt, Rb^Eff, Rb, Rb^Eff, Rb, Rb^Eff, Uu, Rb^Eff, Rb, Rb^Eff, Rb^Eff, Rb^Eff, Rb^Eff, Uhe^Dr, Rb^Eff, Cer, Rb^Eff, Cf^Vud, Rb^Eff, Cer, Rb^Eff, Uhe^Dr, Rb^Eff, Rb^Eff, Rb^Eff, Rb^Eff, Rb, Rb^Eff, Uu, Rb^Eff, Rb, Rb^Eff, Rb, Rb^Eff, Rb^Edt, Rb^Eff, Uu, Rb^Eff, Rb^Eff
Cer, Cer, Cer, Rb^Eff, Cf^Vud, Rb^Eff, Cer, Rb^Eff, Cer, Rb^Eff, Cf^Vud, Rb^Eff, Cer, Rb^Eff, Cer^Edt, Cf^Vud, Cer, Cer, Re, Cer, Re, Cf, Re^Bp|, Cf, Re, Cer, Re, Cer, Cer, Cf^Vud, Cer^Edt, Rb^Eff, Cer, Rb^Eff, Cf^Vud, Rb^Eff, Cer, Rb^Eff, Cer, Rb^Eff, Cf^Vud, Rb^Eff, Cer, Cer
Re, Re, Uu, Cer, Re^Bp|, Cer, Re, Uhe^Dr, Re^Edt, Cer, Re^Bp|, Cer, Re, Cer^Edt, Re, Re^Bp|, Re, Re, Rb^Edt, Re^Edt, Uu, Re, Re, Re, Uu, Re^Edt, Rb^Edt, Re, Re, Re^Bp|, Re, Cer^Edt, Re, Cer, Re^Bp|, Cer, Re^Edt, Uhe^Dr, Re, Cer, Re^Bp|, Cer, Uu, Re
Hhd, Rb^Edt, Hhd, Re, Re, Re^Edt, Rb, Re, Rb, Re, Re, Re, Rb, Re, Uu, Re, Rb, Rb, Hhd, Rb, Hhd, Rb, Re, Rb, Hhd, Rb, Hhd, Rb, Rb, Re, Uu, Re, Rb, Re, Re, Re, Rb, Re, Rb, Re^Edt, Re, Re, Hhd, Rb^Edt
Rb^Fdf, Gll^Fmw, Hhd, Hhd, Gll^Fmw, Re, Hhd, Hhd, Hhd^Fdf, Uu, Re, Hhd, Hhd^Fdf, Hhd, Rb, Re^Edt, Rb, Hhd, Gll^Fdf, Hhd, Rb, Gll^Fmw, Re, Gll^Fmw, Rb, Hhd, Gll^Fdf, Hhd, Rb, Re^Edt, Rb, Hhd, Hhd^Fdf, Hhd, Re, Uu, Hhd^Fdf, Hhd, Hhd, Re, Gll^Fmw, Hhd, Hhd, Gll^Fmw
Rb, Rb, Rb, Rb^Fdf, Re, Re, Rb, Gll^Fmw, Rb, Re, Rb, Gll^Fmw, Rb, Gll^Fmw, Rb, Re, Rb, Gll^Fmw, Rb, Gll^Fmw, Rb, Uu, Re, Uu, Rb, Gll^Fmw, Rb, Gll^Fmw, Rb, Re, Rb, Gll^Fmw, Rb, Gll^Fmw, Rb, Re, Rb, Gll^Fmw, Rb, Re, Re, Rb^Fdf, Rb, Rb
Rb, Uu, Re, Re, Re, Uu, Rb^Edt, Rb, Re, Re, Re, Rb, Re^Edt, Uu, Re, Re, Rb^Edt, Re, Re, Rb, Re^Edt, Rb, Ior^Vct, Rb, Re^Edt, Rb, Re, Re, Rb^Edt, Re, Re, Uu, Re^Edt, Rb, Re, Re, Re, Rb, Rb^Edt, Uu, Re, Re, Re, Uu
Re^Edt, Re^Edt, Re, Ior^Vct, Re, Re^Edt, Re, Re^Edt, Re, Ior^Vct, Re, Re^Edt, Rb, Re, Re, Ior^Vct, Re^Edt, Re^Edt, Rb, Re^Edt, Rb^Edt, Re^Edt, Re^Efs, Re^Edt, Rb^Edt, Re^Edt, Rb, Re^Edt, Re^Edt, Ior^Vct, Re, Re, Rb, Re^Edt, Re, Ior^Vct, Re, Re^Edt, Re, Re^Edt, Re, Ior^Vct, Re, Re^Edt
Rb, Rb, Rb, Rb^Efs, Rb, Rb, Rb, Rb, Re, Re^Efs, Re, Rb, Gll^Fmw, Gll^Fmw, Rb, Re^Efs, Uu, Rb^Edt, Gll^Fmw, Rb, Gll^Fmw, Rb, Rb, Rb, Gll^Fmw, Rb, Gll^Fmw, Rb^Edt, Uu, Re^Efs, Rb, Gll^Fmw, Gll^Fmw, Rb, Re, Re^Efs, Re, Rb, Rb, Rb, Rb, Rb^Efs, Rb, Rb
Rb, Gll, Gll^Fmw, Gll^Fmw, Gll^Fmw, Uu, Re, Re, Ce, Ce, Ce, Re, Rb, Gll^Fdf, Gll, Re, Gll, Gll, Gll^Fmw, Gll^Fdf, Gll^Fmw, Rb, Re, Rb, Gll^Fmw, Gll^Fdf, Gll^Fmw, Gll, Gll, Re, Gll, Gll^Fdf, Rb, Re, Ce, Ce, Ce, Re, Re, Uu, Gll^Fmw, Gll^Fmw, Gll^Fmw, Gll
Hh, Hh, Hh^Fdf, Gll^Fmw, Gll, Re, 1 Ke, Ce, Ce, Ce, Re, Re, Gll, Gll^Fdf, Ior^Vct, Re, Gll, Gll, Hh, Hh^Fmw, Hh^Fmw, Rb, Re, Rb, Hh^Fmw, Hh^Fmw, Hh, Gll, Gll, Re, Ior^Vct, Gll^Fdf, Gll, Re, Re, Ce, Ce, Ce, 2 Ke, Re, Gll, Gll^Fmw, Hh^Fdf, Hh
Hh, Hh, Gll, Gll^Fmw, Gll, Re, Re, Re, Re, Re, Re, Gll, Gll, Gll, Gll^Efs, Gll, Gll, Gll, Hh, Hh, Hh, Re, Re, Re, Hh, Hh, Hh, Gll, Gll, Gll, Gll^Efs, Gll, Gll, Gll, Gll, Re, Re, Re, Re, Re, Gll, Gll^Fmw, Gll, Hh
Rb, Hh, Rb, Gll, Rb, Gll, Rb, Re, Rb, Rb, Rb, Gll, Rb, Gll, Rb, Gll, Rb, Hh, Rb, Hh, Rb, Re, Re, Re, Rb, Hh, Rb, Hh, Rb, Gll, Rb, Gll, Rb, Gll, Rb, Rb, Rb, Re, Rb, Gll, Rb, Gll, Rb, Hh
