Gg, Gg, Gg, Gg, Gg, Gg, Gg, Gg, Gg, Gg, Gg, Gg, Gg, Gg, Gg, Gg, Gg, Gg, Gg, Gg, Gg, Gg
Gg, Gg, Gg^Vfac, Gg, Gg, Gg, Gg, Gg, Gg^Vfac, Gg, Gg, Kha, Kha, Kha, Kha, Gg, Gg, Gg, Gg, Gg, Gg, Gg
Gg, Gg, Gg, Gg, Gg, Gg, Gg, Gg, Gg, Gg, Gg, Kha, Kha, 2 Kte, Kha, Gg, Gg^Vfac, Gg, Gg, Gg^Vfac, Gg, Gg
Gg, Gg, Gg, Gg, Gg, Gg^Vfac, Gg, Gg, Gg, Gg, Gg, Gg, Gg, Kha, Gg, Gg, Gg, Gg, Gg, Gg, Gg, Gg
Ztr, Gg, Ztr, Gg, Ztr, Gg, Ztr, Gg, Ztr, Gg, Ztr, Gg, Ztr, Gg, Ztr, Gg, Ztr, Gg, Ztr, Gg, Ztr, Gg
Gg, Ztr, Gg, Ztr, Gg, Ztr, Gg, Ztr, Gg, Ztr, Gg, Ztr, Gg, Ztr, Gg, Ztr, Gg, Ztr, Gg, Ztr, Gg, Ztr
Gg, Gg, Gg, Gg, Gg, Gg, Gg, Gg, Gg, Gg, Gg, Gg, Gg, Gg, Gg, Gg, Gg, Gg, Gg, Gg, Gg, Gg
Ztr, Gg, Gg, Gg, Gg, Gg, Gg, Gg, Ztr, Gg, Gg, Gg, Ztr, Gg, Ztr, Gg, Ztr, Gg, Ztr, Gg, Gg, Gg
Gg, Ztr, Ztr, Ztr, Ztr, Gg, Gg, Gg, Ztr, Gg, Gg, Gg, Gg, Ztr, Gg, Ztr, Gg, Ztr, Gg, Gg, Qxe, Gg
Gg, Gg, Gg, Gg, Gg, Ztr, Gg, Gg, Ztr, Gg, Gg, Gg, Gg, Gg, Ztr, Gg, Gg, Gg, Gg, Qxe, Qxe, Gg
Gg, Gg, Gg, Gg, Gg, Ztr, Gg, Gg, Ztr, Gg, Gg, Qxe, Qxe, Gg, Ztr, Gg, Gg, Gg, Ztr, Gg, Gg, Gg
Gg, Gg, Gg, Gg, Ztr, Ztr, Gg, Gg, Gg, Ztr, Gg, Qxe, Qxe, Gg, Ztr, Gg, Qxe, Gg, Gg, Ztr, Ztr, Gg
Gg, Gg, Ztr, Ztr, Gg, Gg, Gg, Gg, Ztr, Ztr, Gg, Qxe, Qxe, Gg, Ztr, Gg, Qxe, Gg, Gg, Gg, Gg, Gg
Ztr, Ztr, Gg, Gg, Gg, Gg, Gg, Gg, Ztr, Gg, Gg, Qxe, Gg, Gg, Ztr, Gg, Qxe, Gg, Qxe, Qxe, Qxe, Gg
Gg, Gg, Gg, Gg, Gg, Gg, Gg, Gg, Gg, Gg, Gg, Gg, Gg, Gg, Gg, Gg, Gg, Gg, Gg, Gg, Gg, Gg
Ztr, Gg, Ztr, Gg, Ztr, Gg, Ztr, Gg, Ztr, Gg, Ztr, Gg, Ztr, Gg, Ztr, Gg, Ztr, Gg, Ztr, Gg, Ztr, Gg
Gg, Ztr, Gg, Ztr, Gg, Ztr, Gg, Ztr, Gg, Ztr, Gg, Ztr, Gg, Ztr, Gg, Ztr, Gg, Ztr, Gg, Ztr, Gg, Ztr
Gg, Gg, Gg^Vfac, Gg, Gg, Gg, Gg, Gg, Kf, Kf, Kf, Gg, Gg, Gg, Gg^Vfac, Gg, Gg, Gg, Gg, Gg, Gg, Gg
Gg, Gg, Gg, Gg, Gg, Gg, Gg, Kf, Kf, Kf, Kf, Gg, Gg, Gg, Gg, Gg, Gg, Gg, Gg, Gg, Gg, Gg
Gg, Gg, Gg, Gg^Vfac, Gg, Gg, Gg, Kf, Kf, 1 Kud, Gg, Gg, Gg^Vfac, Gg, Gg, Gg, Gg, Gg^Vfac, Gg, Gg, Gg, Gg
Gg, Gg, Gg, Gg, Gg, Gg, Gg, Gg, Gg, Gg, Gg, Gg, Gg, Gg, Gg, Gg, Gg, Gg, Gg, Gg, Gg, Gg
Gg, Gg, Gg, Gg, Gg, Gg, Gg, Gg, Gg, Gg, Gg, Gg, Gg, Gg, Gg, Gg, Gg, Gg, Gg, Gg, Gg, Gg
